a	a1
abandona  a b a n d o1 n a
abandonai	a b a n d o n a1 i
abandonammo	a b a n d o n a1 m m o
abandonando	a b a n d o n a1 n d o
abandonare	a b a n d o n a1 r e
abandonaste	a b a n d o n a1 s t e
abandonata	a b a n d o n a1 t a
abandonate	a b a n d o n a1 t e
abandonati	a b a n d o n a1 t i
abandonato	a b a n d o n a1 t o
abandonava	a b a n d o n a1 v a
abandonino	a b a n d o1 n i n o
abastanza	a b a s t a1 n ts a
abate	a b a1 t e
abbaglia	a b b a1 LL LL a
abbagliamento	a b b a LL LL a m e1 n t o
abbaia	a b b a1 j a
abbaiano	a b b a1 j a n o
abbaiavano	a b b a j a1 v a n o
abbaino	a b b a i1 n o
abbandonata	a b b a n d o n a1 t a
abbandonati	a b b a n d o n a1 t i
abbandonato	a b b a n d o n a1 t o
abbassare	a b b a s s a1 r e
abbattuta	a b b a t t u1 t a
abbattuti	a b b a t t u1 t i
abbattutissimo	a b b a t t u t i1 s s i m o
abbattuto	a b b a t t u1 t o
abbellimenti	a b b e l l i m e1 n t i
abbi	a1 b b i
abbia	a1 b b j a
abbiamo	a b b j a1 m o
abbiano	a1 b b j a n o
abbiate	a b b j a1 t e
abbisogna	a b b i z o1 JJ JJ a
abboccamento	a b b o k k a m e1 n t o
abbondevolmente	a b b o n d e v o l m e1 n t e
abbraccia	a b b r a1 tSS tSS a
abbracci	a b b r a1 tSS tSS i
abbracciare	a b b r a tSS tSS a1 r e
abbracciati	a b b r a tSS tSS a1 t i
abbracciò	a b b r a tSS tSS OO
abitanti	a b i t a1 n t i
abitare	a b i t a1 r e
abitazione	a b i t a ts ts j o1 n e
abiti	a1 b i t i
abito	a1 b i t o
abnegazione	a b n e g a ts ts j o1 n e
accaduto	a k k a d u1 t o
accampando	a k k a m p a1 n d o
accampare	a k k a m p a1 r e
accanto	a k k a1 n t o
accasciamento	a k k a SS SS a m e1 n t o
accendere	a tSS tSS EE n d e r e
accennò	a tSS tSS e n n OO
accenti	a tSS tSS EE n t i
accento	a tSS tSS EE n t o
accesa	a tSS tSS e1 s a
accese	a tSS tSS e1 s e
accesi	a tSS tSS e1 s i
acceso	a tSS tSS e1 s o
accidente	a tSS tSS i d EE n t e
accidenti	a tSS tSS i d EE n t i
accompagnarmi	a k k o m p a JJ JJ a1 r m i
accompagnata	a k k o m p a JJ JJ a1 t a
accompagnate	a k k o m p a JJ JJ a1 t e
accompagnati	a k k o m p a JJ JJ a1 t i
accompagnato	a k k o m p a JJ JJ a1 t o
acconcia	a k k o1 n tSS a
acconci	a k k o1 n tSS i
acconciamente	a k k o n tSS a m e1 n t e
acconciare	a k k o n tSS a1 r e
acconcio	a k k o1 n tSS o
accorge	a k k OO r dZZ e
accorgendo	a k k o r dZZ EE n d o
accorta	a k k OO r t a
accorti	a k k OO r t i
accorto	a k k OO r t o
accresce	a k k r e1 SS SS e
accrescere	a k k r e1 SS SS e r e
accrescimento	a k k r e SS SS i m e1 n t o
accusa	a k k u1 z a
accusato	a k k u z a1 t o
acerba	a tSS EE r b a
achille	a k i1 l l e
aci	a1 tSS i
acqua	a1 k k w a
acque	a1 k k w e
acquistare	a k k w i s t a1 r e
acquistasse	a k k w i s t a1 s s e
acquistata	a k k w i s t a1 t a
acquistato	a k k w i s t a1 t o
acquistò	a k k w i s t OO
acuta	a k u1 t a
acuto	a k u1 t o
ad	a1 d
adamo	a d a1 m o
addietro	a d d j EE t r o
addio	a d d i1 o
addivenne	a d d i v e1 n n e
addormentare	a d d o r m e n t a1 r e
addormentato	a d d o r m e n t a1 t o
addosso	a d d OO s s o
adempiere	a d e1 m p j e r e
adesso	a d EE s s o
adirato	a d i r a1 t o
adito	a d i1 t o
adone	a d o1 n e
adopera	a d OO p e r a
adoperare	a d o p e r a1 r e
adoperata	a d o p e r a1 t a
adoperato	a d o p e r a1 t o
adoperò	a d o p e r OO
adorata	a d o r a1 t a
adorato	a d o r a1 t o
adorna	a d o1 r n a
adornamento	a d o r n a m e1 n t o
adorno	a d o1 r n o
adosso	a d OO s s o
adriano	a d r j a1 n o
adulterio	a d u l t EE r j o
adunati	a d u n a1 t i
adunque	a d u1 ng k w e
affabile	a f f a1 b i l e
affabilissimamente	a f f a b i l i s s i m a m e1 n t e
affannare	a f f a n n a1 r e
affannato	a f f a n n a1 t o
affanni	a f f a1 n n i
affanno	a f f a1 n n o
affare	a f f a1 r e
affari	a f f a1 r i
affaticato	a f f a t i k a1 t o
affatto	a f f a1 t t o
afferma	a f f e1 r m a
affermando	a f f e r m a1 n d o
affermano	a f f e1 r m a n o
affermare	a f f e r m a1 r e
affermava	a f f e r m a1 v a
affermi	a f f e1 r m i
affermo	a f f e1 r m o
affermò	a f f e r m OO
affetti	a f f EE t t i
affetto	a f f EE t t o
affettuosa	a f f e t t u o1 s a
affettuosamente	a f f e t t u o s a m e1 n t e
affezione	a f f e ts ts j o1 n e
affidabilità	a f f i d a b i l i t a1
affine	a f f i1 n e
afflitta	a f f l i1 t t a
afflitti	a f f l i1 t t i
afflitto	a f f l i1 t t o
afflizione	a f f l i ts ts j o1 n e
affogato	a f f o g a1 t o
africa	a1 f r i k a
africani	a f r i k a1 n i
africano	a f r i k a1 n o
agevole	a dZZ e1 v o l e
agevoli	a dZZ e1 v o l i
agevolmente	a dZZ e v o l m e1 n t e
aggia	a1 dZZ dZZ a
aggiunge	a dZZ dZZ u1 n dZZ e
aggiungendo	a dZZ dZZ u n dZZ EE n d o
aggiungere	a dZZ dZZ u1 n dZZ e r e
aggiunse	a dZZ dZZ u1 n s e
aggiunsero	a dZZ dZZ u1 n s e r o
aggiunta	a dZZ dZZ u1 n t a
aggiunto	a dZZ dZZ u1 n t o
agguagliare	a g g w a LL LL a1 r e
agio	a1 dZZ o
agli	a1 LL LL i
agnolo	a1 JJ JJ o l o
agostino	a g o s t i1 n o
agresti	a g r EE s t i
agricoltori	a g r i k o l t o1 r i
aguti	a g u1 t i
ah	a1
ahi	a1 i
ahimè	a i m EE
ai	a1 i
aiuta	a j u1 t a
aiutare	a j u t a1 r e
aiutata	a j u t a1 t a
aiutato	a j u t a1 t o
aiuterà	a j u t e r a1
aiuti	a j u1 t i
aiuto	a j u1 t o
al	a1 l
alba	a1 l b a
albergare	a l b e r g a1 r e
albergato	a l b e r g a1 t o
albergo	a l b EE r g o
alberi	a1 l b e r i
alberico	a l b e r i1 k o
albero	a1 l b e r o
alberto	a l b EE r t o
alcione	a l tSS o1 n e
alcmena	a l k m EE n a
alcuna	a l k u1 n a
alcune	a l k u1 n e
alcuni	a l k u1 n i
alcuno	a l k u1 n o
aldo	a1 l d o
alessandria	a l e s s a1 n d r j a
alessandro	a l e s s a1 n d r o
aletto	a l e1 t t o
alfeo	a l f EE o
ali	a1 l i
alighieri	a l i g j EE r i
alla	a1 l l a
allato	a l l a1 t o
alle	a1 l l e
alleanza	a l l e a1 n ts a
alleggiamento	a l l e dZZ dZZ a m e1 n t o
allegra	a l l e1 g r a
allegrezza	a l l e g r e1 ts ts a
allegri	a l l e1 g r i
allegro	a l l e1 g r o
allevati	a l l e v a1 t i
allevato	a l l e v a1 t o
allo	a1 l l o
allora	a l l o1 r a
allorchè	a l l o r k EE
allori	a l l OO r i
alloro	a l l OO r o
almeno	a l m e1 n o
alquanta	a l k w a1 n t a
alquante	a l k w a1 n t e
alquanti	a l k w a1 n t i
alquanto	a l k w a1 n t o
alta	a1 l t a
altamente	a l t a m e1 n t e
altare	a l t a1 r e
altari	a l t a1 r i
alte	a1 l t e
altezza	a l t e1 ts ts a
alti	a1 l t i
altissima	a l t i1 s s i m a
altissime	a l t i1 s s i m e
altissimi	a l t i1 s s i m i
altissimo	a l t i1 s s i m o
alto	a1 l t o
altra	a1 l t r a
altramenti	a l t r a m e1 n t i
altre	a1 l t r e
altresì	a l t r e s i1
altressì	a l t r e s s i1
altrettante	a l t r e t t a1 n t e
altrettanto	a l t r e t t a1 n t o
altri	a1 l t r i
altrimenti	a l t r i m e1 n t i
altro	a1 l t r o
altronde	a l t r o1 n d e
altrove	a l t r o1 v e
altrui	a l t r u1 i
alvise	a l v i1 z e
alza	a1 l ts a
alzata	a l ts a1 t a
alzato	a l ts a1 t o
alzò	a l ts OO
ama	a1 m a
amai	a m a1 i
amando	a m a1 n d o
amano	a1 m a n o
amante	a m a1 n t e
amanti	a m a1 n t i
amara	a m a1 r a
amaramente	a m a r a m e1 n t e
amare	a m a1 r e
amarezza	a m a r e1 ts ts a
amaro	a m a1 r o
amasse	a m a1 s s e
amassi	a m a1 s s i
amata	a m a1 t a
amate	a m a1 t e
amati	a m a1 t i
amato	a m a1 t o
amatore	a m a t o1 r e
amava	a m a1 v a
amazzone	a m a1 dz dz o n e
ambasciata	a m b a SS SS a1 t a
ambasciate	a m b a SS SS a1 t e
amendue	a m e n d u1 e
amenduni	a m e n d u1 n i
amerigo	a m e r i1 g o
amerò	a m e r OO
ami	a1 m i
amiamo	a m j a1 m o
amica	a m i1 k a
amiche	a m i1 k e
amichevolmente	a m i k e v o l m e1 n t e
amici	a m i1 tSS i
amicizia	a m i tSS i1 ts ts j a
amico	a m i1 k o
amistà	a m i s t a1
ammaestramenti	a m m a e s t r a m e1 n t i
ammaestrati	a m m a e s t r a1 t i
ammaestrato	a m m a e s t r a1 t o
ammaestrò	a m m a e s t r OO
ammazzò	a m m a ts ts OO
ammenda	a m m EE n d a
ammirazione	a m m i r a ts ts j o1 n e
amo	a1 m o
amò	a m OO
amore	a m o1 r e
amori	a m o1 r i
amorosa	a m o r o1 s a
amorosamente	a m o r o s a m e1 n t e
amorose	a m o r o1 s e
amorosi	a m o r o1 s i
amoroso	a m o r o1 s o
ampi	a1 m p i
ampia	a1 m p j a
ampiamente	a m p j a m e1 n t e
ampie	a1 m p j e
ampio	a1 m p j o
anche	a1 ng k e
anco	a1 ng k o
ancora	a ng k o1 r a
andai	a n d a1 i
andando	a n d a1 n d o
andare	a n d a1 r e
andarono	a n d a1 r o n o
andasse	a n d a1 s s e
andassero	a n d a1 s s e r o
andata	a n d a1 t a
andate	a n d a1 t e
andati	a n d a1 t i
andato	a n d a1 t o
andava	a n d a1 v a
andavano	a n d a1 v a n o
andiamo	a n d j a1 m o
andò	a n d OO
andrà	a n d r a1
andrebbe	a n d r EE b b e
andrò	a n d r OO
andromaca	a n d r OO m a k a
andromeda	a n d r OO m e d a
anella	a n EE l l a
anello	a n EE l l o
anfitrione	a nf f i t r i o1 n e
angeli	a1 n dZZ e l i
angelo	a1 n dZZ e l o
angolo	a1 ng g o l o
angoscia	a ng g OO SS SS a
angosciosa	a ng g o SS SS o1 s a
angoscioso	a ng g o SS SS o1 s o
anima	a1 n i m a
animale	a n i m a1 l e
animali	a n i m a1 l i
anime	a n i1 m e
animi	a n i1 m i
animo	a1 n i m o
animosamente	a n i m o s a m e1 n t e
animoso	a n i m o1 s o
annali	a n n a1 l i
anni	a1 n n i
anno	a1 n n o
annoverare	a n n o v e r a1 r e
ansaldo	a n s a1 l d o
anselmo	a n s EE l m o
antecessori	a n t e tSS e s s o1 r i
antica	a n t i1 k a
anticamente	a n t i k a m e1 n t e
antiche	a n t i1 k e
antichi	a n t i1 k i
antichissima	a n t i k i1 s s i m a
antichissimi	a n t i k i1 s s i m i
antichissimo	a n t i k i1 s s i m o
antichità	a n t i k i t a1
antico	a n t i1 k o
antiopa	a n t i1 o p a
antonio	a n t OO n j o
antri	a1 n t r i
anzi	a1 n ts i
aperse	a p EE r s e
aperta	a p EE r t a
apertamente	a p e r t a m e1 n t e
aperte	a p EE r t e
aperti	a p EE r t i
aperto	a p EE r t o
api	a1 p i
apollo	a p OO l l o
apostoli	a p OO s t o l i
apostolo	a p OO s t o l o
appaia	a p p a i a
appaiono	a p p a1 j o n o
apparato	a p p a r a1 t o
appare	a p p a1 r e
apparecchiare	a p p a r e k k j a1 r e
apparecchiata	a p p a r e k k j a1 t a
apparecchiate	a p p a r e k k j a1 t e
apparecchiati	a p p a r e k k j a1 t i
apparecchiato	a p p a r e k k j a1 t o
apparecchiò	a p p a r e k k j OO
apparenza	a p p a r EE n ts a
apparire	a p p a r i1 r e
apparisce	a p p a r i1 SS SS e
apparisse	a p p a r i1 s s e
appariva	a p p a r i1 v a
appartenenti	a p p a r t e n EE n t i
appartiene	a p p a r t j EE n e
apparve	a p p a1 r v e
appena	a p p e1 n a
appetiti	a p p e t i1 t i
appetito	a p p e t i1 t o
appiccato	a p p i k k a1 t o
apporta	a p p OO r t a
apprendere	a p p r EE n d e r e
appreso	a p p r e1 s o
appresso	a p p r EE s s o
apprestare	a p p r e s t a1 r e
appunto	a p p u1 n t o
apri	a1 p r i
aprì	a p r i1
aprire	a p r i1 r e
aquila	a1 k w i l a
arbitrio	a r b i1 t r j o
arca	a1 r k a
arcade	a1 r k a d e
arcadi	a1 r k a d i
archi	a1 r k i
arco	a1 r k o
arde	a1 r d e
ardendo	a r d EE n d o
ardente	a r d EE n t e
ardenti	a r d EE n t i
ardentissimo	a r d e n t i1 s s i m o
ardere	a1 r d e r e
ardesse	a r d e1 s s e
ardeva	a r d e1 v a
ardire	a r d i1 r e
ardita	a r d i1 t a
arditamente	a r d i t a m e1 n t e
arditi	a r d i1 t i
ardito	a r d i1 t o
ardiva	a r d i1 v a
ardo	a1 r d o
ardore	a r d o1 r e
arene	a r e1 n e
argivi	a r dZZ i1 v i
argomentare	a r g o m e n t a1 r e
argomenti	a r g o m e1 n t i
argomento	a r g o m e1 n t o
argonauti	a r g o n a1 u t i
aria	a1 r j a
arianna	a r j a1 n n a
armare	a r m a1 r e
armata	a r m a1 t a
armati	a r m a1 t i
armato	a r m a1 t o
arme	a1 r m e
armenti	a r m e1 n t i
armi	a1 r m i
armonia	a r m o n i1 a
arnese	a r n e1 s e
arnesi	a r n e1 s i
arpie	a r p i1 e
arrigo	a r r i1 g o
arrivare	a r r i v a1 r e
arrivata	a r r i v a1 t a
arrivato	a r r i v a1 t o
arrivò	a r r i v OO
arsa	a1 r s a
arse	a1 r s e
arsi	a1 r s i
arso	a1 r s o
arte	a1 r t e
artefice	a r t e1 f i tSS e
artefici	a r t e1 f i tSS i
arti	a1 r t i
articoli	a r t i1 k o l i
articolo	a r t i1 k o l o
artificio	a r t i f i1 tSS o
ascanio	a s k a1 n j o
ascendente	a SS SS e n d EE n t e
ascolta	a s k o1 l t a
ascoltando	a s k o l t a1 n d o
ascoltanti	a s k o l t a1 n t i
ascoltare	a s k o l t a1 r e
ascoltata	a s k o l t a1 t a
ascoltate	a s k o l t a1 t e
ascoltato	a s k o l t a1 t o
ascoltava	a s k o l t a1 v a
ascoltò	a s k o l t OO
asia	a1 z j a
asini	a1 s i n i
asino	a1 s i n o
aspetta	a s p EE t t a
aspettando	a s p e t t a1 n d o
aspettare	a s p e t t a1 r e
aspettata	a s p e t t a1 t a
aspettato	a s p e t t a1 t o
aspettava	a s p e t t a1 v a
aspetti	a s p EE t t i
aspetto	a s p EE t t o
aspettò	a s p e t t OO
aspra	a1 s p r a
aspramente	a s p r a m e1 n t e
aspre	a1 s p r e
asprezza	a s p r e1 ts ts a
aspri	a1 s p r i
aspro	a1 s p r o
assai	a s s a1 i
assalire	a s s a l i1 r e
assalita	a s s a l i1 t a
assaliti	a s s a l i1 t i
assalito	a s s a l i1 t o
assalitori	a s s a l i t o1 r i
assalti	a s s a1 l t i
assalto	a s s a1 l t o
assenza	a s s EE n ts a
assetto	a s s EE t t o
assiri	a s s i1 r i
assolutamente	a s s o l u t a m e1 n t e
assunto	a s s u1 n t o
astrea	a s t r EE a
astrologhi	a s t r OO l o g i
atta	a1 t t a
atte	a1 t t e
attempati	a t t e m p a1 t i
attempato	a t t e m p a1 t o
attendendo	a t t e n d EE n d o
attendere	a t t EE n d e r e
attendeva	a t t e n d e1 v a
attenta	a t t EE n t a
attentamente	a t t e n t a m e1 n t e
attento	a t t EE n t o
attenzione	a t t e n ts j o1 n e
attese	a t t e1 s e
atteso	a t t e1 s o
atti	a1 t t i
atto	a1 t t o
attorno	a t t o1 r n o
attratto	a t t r a1 t t o
attraverso	a t t r a v EE r s o
attribuire	a t t r i b u i1 r e
attribuiscono	a t t r i b u i1 s k o n o
attribuita	a t t r i b u i1 t a
attribuite	a t t r i b u i1 t e
attribuiti	a t t r i b u i1 t i
attribuito	a t t r i b u i1 t o
audaci	a u d a1 tSS i
auguri	a u g u1 r i
augurio	a u g u1 r j o
augusto	a u g u1 s t o
aura	a1 u r a
aure	a1 u r e
aurora	a u r OO r a
ausonio	a u z OO n j o
austro	a1 u s t r o
autore	a u t o1 r e
autori	a u t o1 r i
autorità	a u t o r i t a1
autunno	a u t u1 n n o
avanti	a v a1 n t i
avari	a v a1 r i
avarizia	a v a r i1 ts ts j a
avaro	a v a1 r o
avea	a v e1 a
avello	a v EE l l o
avemo	a v e1 m o
avendo	a v EE n d o
aventino	a v e n t i1 n o
avere	a v e1 r e
averla	a v EE r l a
avesse	a v e1 s s e
avessero	a v e1 s s e r o
avessi	a v e1 s s i
aveste	a v e1 s t e
avesti	a v e1 s t i
avete	a v e1 t e
aveva	a v e1 v a
avevano	a v e1 v a n o
avevi	a v e1 v i
avevo	a v e1 v o
avezzi	a v e1 ts ts i
avezzo	a v e1 ts ts o
avo	a1 v o
avoli	a v OO l i
avrà	a v r a1
avrai	a v r a1 i
avranno	a v r a1 n n o
avrebbe	a v r EE b b e
avrebbero	a v r EE b b e r o
avrei	a v r EE i
avremmo	a v r e1 m m o
avremo	a v r e1 m o
avreste	a v r e1 s t e
avresti	a v r e1 s t i
avrete	a v r e1 t e
avria	a v r i1 a
avrò	a v r OO
avuta	a v u1 t a
avute	a v u1 t e
avuti	a v u1 t i
avuto	a v u1 t o
avveduto	a v v e d u1 t o
avvegna	a1 v v e JJ JJ a
avvelenare	a v v e l e n a1 r e
avvenga	a v v EE ng g a
avvenimenti	a v v e n i m e1 n t i
avvenimento	a v v e n i m e1 n t o
avvenire	a v v e n i1 r e
avvenisse	a v v e n i1 s s e
avveniva	a v v e n i1 v a
avvenne	a v v e1 n n e
avvenuta	a v v e n u1 t a
avvenute	a v v e n u1 t e
avvenuto	a v v e n u1 t o
avverrà	a v v e r r a1
avversarii	a v v e r s a1 r j i
avversario	a v v e r s a1 r j o
avversi	a v v EE r s i
avversità	a v v e r s i t a1
avviene	a v v i EE n e
avviso	a v v i1 z o
azione	a ts ts j o1 n e
azioni	a ts ts j o1 n i
babilonia	b a b i l OO n j a
baciare	b a tSS a1 r e
baciata	b a tSS a1 t a
baciava	b a tSS a1 v a
baci	b a1 tSS i
bacio	b a tSS i1 o
baciò	b a tSS OO
badessa	b a d e1 s s a
bagnare	b a JJ JJ a1 r e
bagnata	b a JJ JJ a1 t a
bagnato	b a JJ JJ a1 t o
bagni	b a1 JJ JJ i
bagno	b a1 JJ JJ o
bagnò	b a JJ JJ OO
balene	b a l e1 n e
balia	b a1 l j a
balli	b a1 l l i
ballo	b a1 l l o
banco	b a1 ng k o
bandiera	b a n d j EE r a
bandiere	b a n d j EE r e
bando	b a1 n d o
barattiere	b a r a t t j EE r e
barba	b a1 r b a
barbari	b a1 r b a r i
barbaro	b a1 r b a r o
barchetta	b a r k e1 t t a
barone	b a r o1 n e
baroni	b a r o1 n i
bassa	b a1 s s a
basse	b a1 s s e
bassi	b a1 s s i
basso	b a1 s s o
basta	b a1 s t a
bastanti	b a s t a1 n t i
bastardo	b a s t a1 r d o
bastare	b a s t a1 r e
bastasse	b a s t a1 s s e
bastava	b a s t a1 v a
basterà	b a s t e r a1
bastevole	b a s t e1 v o l e
basti	b a1 s t i
bastone	b a s t o1 n e
battaglia	b a t t a1 LL LL a
battaglie	b a t t a1 LL LL e
batte	b a1 t t e
battere	b a1 t t e r e
battesimo	b a t t e1 z i m o
battitura	b a t t i t u1 r a
battiture	b a t t i t u1 r e
batto	b a1 t t o
battuta	b a t t u1 t a
battuto	b a t t u1 t o
b	b
beata	b e a1 t a
beati	b e a1 t i
beatitudine	b e a t i t u1 d i n e
beato	b e a1 t o
beatrice	b e a t r i1 tSS e
beffa	b EE f f a
beffare	b e f f a1 r e
beffati	b e f f a1 t i
beffato	b e f f a1 t o
beffe	b EE f f e
begli	b EE LL LL i
bel	b EE l
bella	b EE l l a
belle	b EE l l e
bellezza	b e l l e1 ts ts a
bellezze	b e l l e1 ts ts e
belli	b EE l l i
bellissima	b e l l i1 s s i m a
bellissime	b e l l i1 s s i m e
bellissimi	b e l l i1 s s i m i
bellissimo	b e l l i1 s s i m o
bello	b EE l l o
belo	b EE l o
benché	b e ng k e1
bene	b EE n e
benedetta	b e n e d e1 t t a
benedetto	b e n e d e1 t t o
benedizione	b e n e d i ts ts j o1 n e
benefici	b e n e f i1 tSS i
beneficio	b e n e f i1 tSS o
benevento	b EE n e v EE n t o
beni	b EE n i
benigna	b e n i1 JJ JJ a
benignamente	b e n i JJ JJ a m e1 n t e
benigni	b e n i1 JJ JJ i
benignità	b e n i JJ JJ i t a1
benigno	b e n i1 JJ JJ o
benissimo	b e n i1 s s i m o
bensì	b e n s i1
bere	b e1 r e
berenice	b e r e n i1 tSS e
bernardo	b e r n a1 r d o
bestia	b e1 s t j a
bestiale	b e s t j a1 l e
bestialità	b e s t j a l i t a1
bestie	b e1 s t j e
bevanda	b e v a1 n d a
bevendo	b e v EE n d o
beveraggio	b e v e r a1 dZZ dZZ o
bevitori	b e v i t o1 r i
bevuto	b e v u1 t o
bevve	b e1 v v e
biade	b j a1 d e
bianca	b j a1 ng k a
bianche	b j a1 ng k e
bianchezza	b j a ng k e1 ts ts a
bianchi	b j a1 ng k i
bianchissima	b j a ng k i1 s s i m a
bianchissime	b j a ng k i1 s s i m e
bianco	b j a1 ng k o
biante	b i a1 n t e
biasimando	b j a z i m a1 n d o
biasimare	b j a z i m a1 r e
biasimato	b j a z i m a1 t o
biasimo	b j a1 z i m o
biblioteca	b i b l j o t EE k a
bicchiere	b i k k j EE r e
bicchieri	b i k k j EE r i
bionda	b j o1 n d a
biondi	b j o1 n d i
bisanti	b i z a1 n t i
bisogna	b i z o1 JJ JJ a
bisognano	b i z o1 JJ JJ a n o
bisognasse	b i z o JJ JJ a1 s s e
bisognava	b i z o JJ JJ a1 v a
bisogne	b i z o1 JJ JJ e
bisognerà	b i z o JJ JJ e r a1
bisognerebbe	b i z o JJ JJ e r EE b b e
bisogni	b i z o1 JJ JJ i
bisogno	b i z o1 JJ JJ o
bocca	b o1 k k a
bocche	b o1 k k e
bologna	b o l OO JJ JJ a
bolognese	b o l o JJ JJ e1 s e
bonaparte	b OO n a p a1 r t e
bontà	b o n t a1
borea	b OO r e a
borgo	b o1 r g o
boschi	b OO s k i
bosco	b OO s k o
bovio	b OO v j o
braccia	b r a1 tSS tSS a
braccio	b r a1 tSS tSS o
brache	b r a1 k e
brava	b r a1 v a
bravo	b r a1 v o
breve	b r EE v e
brevemente	b r e v e m e1 n t e
brevi	b r EE v i
brevissimo	b r e v i1 s s i m o
brevità	b r e v i t a1
brieve	b r j EE v e
brievemente	b r j e v e m e1 n t e
brievi	b r j EE v i
brigata	b r i g a1 t a
brigate	b r i g a1 t e
bronzo	b r o1 n dz o
brun	b r u1 n
bruno	b r u1 n o
bruti	b r u1 t i
bruto	b r u1 t o
brutta	b r u1 t t a
brutto	b r u1 t t o
bruttura	b r u t t u1 r a
bucolica	b u k OO l i k a
bue	b u1 e
bugiardi	b u dZZ a1 r d i
bugiardo	b u dZZ a1 r d o
buio	b u1 j o
buoi	b w OO i
buona	b w OO n a
buone	b w OO n e
buoni	b w OO n i
buono	b w OO n o
bus	b u1 s
busto	b u1 s t o
caccia	k a1 tSS tSS a
cacciando	k a tSS tSS a1 n d o
cacciare	k a tSS tSS a1 r e
cacciata	k a tSS tSS a1 t a
cacciate	k a tSS tSS a1 t e
cacciati	k a tSS tSS a1 t i
cacciato	k a tSS tSS a1 t o
cacciatore	k a tSS tSS a t o1 r e
cacciatori	k a tSS tSS a t o1 r i
cacciò	k a tSS tSS OO
caco	k a1 k o
cadde	k a1 d d e
caddero	k a1 d d e r o
cade	k a1 d e
cadendo	k a d EE n d o
cadere	k a d e1 r e
cadesse	k a d e1 s s e
cadono	k a1 d o n o
caduca	k a d u1 k a
caduco	k a d u1 k o
caduta	k a d u1 t a
caduti	k a d u1 t i
caduto	k a d u1 t o
caffè	k a f f EE
cagione	k a dZZ o1 n e
cagioni	k a dZZ o1 n i
cagnolino	k a JJ JJ o l i1 n o
calai	k a l a1 i
calandrino	k a l a1 n d r i n o
calda	k a1 l d a
calde	k a1 l d e
caldi	k a1 l d i
caldo	k a1 l d o
calere	k a l e1 r e
calesse	k a l EE s s e
calido	k a1 l i d o
caligine	k a l i1 dZZ i n e
calisto	k a l i1 s t o
calma	k a1 l m a
calore	k a l o1 r e
cambiato	k a m b j a1 t o
cambiò	k a m b j OO
camicia	k a m i1 tSS a
camminando	k a m m i n a1 n d o
cammino	k a m m i1 n o
campagna	k a m p a1 JJ JJ a
campagne	k a m p a1 JJ JJ e
campa	k a1 m p a
campare	k a m p a1 r e
campidoglio	k a m p i d OO LL LL o
campi	k a1 m p i
campo	k a1 m p o
canale	k a n a1 l e
candia	k a1 n d j a
candidi	k a1 n d i d i
candido	k a1 n d i d o
cane	k a1 n e
cani	k a1 n i
can	k a1 n
cannelle	k a n n EE l l e
canta	k a1 n t a
cantando	k a n t a1 n d o
cantano	k a1 n t a n o
cantare	k a n t a1 r e
cantarono	k a n t a1 r o n o
cantate	k a n t a1 t e
cantava	k a n t a1 v a
cantavano	k a n t a1 v a n o
canti	k a1 n t i
canto	k a1 n t o
cantò	k a n t OO
canzone	k a n ts o1 n e
canzonette	k a n ts o n e1 t t e
canzoni	k a n ts o1 n i
capace	k a p a1 tSS e
capanne	k a p a1 n n e
capelli	k a p e1 l l i
capello	k a p e1 l l o
capevole	k a p e1 v o l e
capi	k a1 p i
capire	k a p i1 r e
capita	k a p i1 t a
capitale	k a p i t a1 l e
capitani	k a p i t a1 n i
capitano	k a p i t a1 n o
capitavano	k a p i t a1 v a n o
capitò	k a p i t OO
capitoli	k a p i1 t o l i
capitolo	k a p i1 t o l o
capo	k a1 p o
cappa	k a1 p p a
cappello	k a p p EE l l o
capponi	k a p p o1 n i
cappuccio	k a p p u1 tSS tSS o
capra	k a1 p r a
cara	k a1 r a
carattere	k a r a1 t t e r e
caratteri	k a r a1 t t e r i
carboni	k a r b o1 n i
carcere	k a1 r tSS e r e
cardinale	k a r d i n a1 l e
cardinali	k a r d i n a1 l i
care	k a1 r e
carezze	k a r e1 ts ts e
carico	k a1 r i k o
cari	k a1 r i
carissima	k a r i1 s s i m a
carissime	k a r i1 s s i m e
carissimo	k a r i1 s s i m o
carità	k a r i t a1
carlo	k a1 r l o
carnale	k a r n a1 l e
carne	k a1 r n e
carni	k a1 r n i
caro	k a1 r o
carretta	k a r r e1 t t a
carrette	k a r r e1 t t e
carro	k a1 r r o
carrozza	k a r r OO ts ts a
carrozzino	k a r r o ts ts i1 n o
carta	k a1 r t a
carte	k a1 r t e
casa	k a1 s a
case	k a1 s e
casi	k a1 z i
caso	k a1 z o
cassa	k a1 s s a
cassetta	k a s s e1 t t a
casta	k a1 s t a
castaldo	k a s t a1 l d o
castellano	k a s t e l l a1 n o
castello	k a s t EE l l o
castità	k a s t i t a1
casto	k a1 s t o
catella	k a t EE l l a
catena	k a t e1 n a
catene	k a t e1 n e
caterina	k a t e r i1 n a
catone	k a t o1 n e
cattaneo	k a t t a1 n e o
cattiva	k a t t i1 v a
cattive	k a t t i1 v e
cattivella	k a t t i v EE l l a
cattivi	k a t t i1 v i
cattività	k a t t i v i t a1
cattivo	k a t t i1 v o
cattolica	k a t t OO l i k a
causa	k a1 u z a
causato	k a u z a1 t o
cause	k a1 u z e
cautamente	k a u t a m e1 n t e
cautela	k a u t EE l a
cavalcando	k a v a l k a1 n d o
cavalcanti	k a v a l k a1 n t i
cavalcare	k a v a l k a1 r e
cavalcarono	k a v a l k a1 r o n o
cavalcava	k a v a l k a1 v a
cavaliere	k a v a l j EE r e
cavalieri	k a v a l j EE r i
cavalla	k a v a1 l l a
cavalli	k a v a1 l l i
cavallino	k a v a l l i1 n o
cavallo	k a v a1 l l o
cavare	k a v a1 r e
cavata	k a v a1 t a
cavati	k a v a1 t i
cavato	k a v a1 t o
cave	k a1 v e
caverne	k a v EE r n e
cavò	k a v OO
cecità	tSS e tSS i t a1
cedere	tSS EE d e r e
cefalo	tSS EE f a l o
celebrare	tSS e l e b r a1 r e
celebrato	tSS e l e b r a1 t o
celebravano	tSS e l e b r a1 v a n o
celeste	tSS e l EE s t e
celestiale	tSS e l e s t j a1 l e
celestiali	tSS e l e s t j a1 l i
celesti	tSS e l EE s t i
celio	tSS EE l j o
celi	tSS EE l i
cella	tSS EE l l a
cenare	tSS e n a1 r e
cenarono	tSS e n a1 r o n o
cenato	tSS e n a1 t o
cena	tSS e1 n a
cenere	tSS e1 n e r e
ceneri	tSS e1 n e r i
cenno	tSS e1 n n o
cenò	tSS e n OO
centauri	tSS e n t a1 u r i
centauro	tSS e n t a1 u r o
cento	tSS EE n t o
centro	tSS EE n t r o
cera	tSS e1 r a
cerbero	tSS EE r b e r o
cercai	tSS e r k a1 i
cercando	tSS e r k a1 n d o
cercano	tSS e1 r k a n o
cercare	tSS e r k a1 r e
cercarono	tSS e r k a1 r o n o
cercata	tSS e r k a1 t a
cercate	tSS e r k a1 t e
cercati	tSS e r k a1 t i
cercato	tSS e r k a1 t o
cerca	tSS e1 r k a
cercavano	tSS e r k a1 v a n o
cercava	tSS e r k a1 v a
cerchiamo	tSS e r k j a1 m o
cerchio	tSS e1 r k j o
cerchi	tSS e1 r k i
cerco	tSS e1 r k o
cercò	tSS e r k OO
certaldo	tSS e r t a1 l d o
certamente	tSS e r t a m e1 n t e
certa	tSS EE r t a
certe	tSS EE r t e
certezza	tSS e r t e1 ts ts a
certissima	tSS e r t i1 s s i m a
certissimo	tSS e r t i1 s s i m o
certi	tSS EE r t i
certo	tSS EE r t o
cerva	tSS EE r v a
cervello	tSS e r v EE l l o
cervi	tSS EE r v i
cervo	tSS EE r v o
cesare	tSS EE z a r e
cesari	tSS EE z a r i
cessando	tSS e s s a1 n d o
cessano	tSS EE s s a n o
cessare	tSS e s s a1 r e
cessate	tSS e s s a1 t e
cessato	tSS e s s a1 t o
cessino	tSS EE s s i n o
cessi	tSS EE s s i
cessò	tSS e s s OO
cesta	tSS e1 s t a
cetera	tSS EE t e r a
che	k e1
ché	k e1
chente	k EE n t e
chenti	k EE n t i
cheta	k e1 t a
chetamente	k e t a m e1 n t e
cheto	k e1 t o
chiamai	k j a m a1 i
chiama	k j a1 m a
chiamando	k j a m a1 n d o
chiamano	k j a1 m a n o
chiamare	k j a m a1 r e
chiamarono	k j a m a1 r o n o
chiamasse	k j a m a1 s s e
chiamata	k j a m a1 t a
chiamate	k j a m a1 t e
chiamati	k j a m a1 t i
chiamato	k j a m a1 t o
chiamava	k j a m a1 v a
chiamavano	k j a m a1 v a n o
chiamiamo	k j a m j a1 m o
chiami	k j a1 m i
chiamo	k j a1 m o
chiamò	k j a m OO
chiara	k j a1 r a
chiaramente	k j a r a m e1 n t e
chiare	k j a1 r e
chiarezza	k j a r e1 ts ts a
chiari	k j a1 r i
chiarissima	k j a r i1 s s i m a
chiarissimi	k j a r i1 s s i m i
chiarissimo	k j a r i1 s s i m o
chiaro	k j a1 r o
chiave	k j a1 v e
chiavi	k j a1 v i
chiede	k j EE d e
chiedere	k j EE d e r e
chiedeva	k j e d e1 v a
chiesa	k j EE z a
chiese	k j EE z e
chiesto	k j EE s t o
chi	k i
chimera	k i m EE r a
chino	k i1 n o
chinò	k i n OO
chiodo	k j OO d o
chioma	k j OO m a
chiude	k j u1 d e
chiudere	k j u1 d e r e
chiusa	k j u1 s a
chiuse	k j u1 s e
chiusi	k j u1 s i
chiuso	k j u1 s o
christiana	k r i s t j a1 n a
ciacco	tSS a1 k k o
ciance	tSS a1 n tSS e
cianciatori	tSS a n tSS a t o1 r i
ciascheduno	tSS a s k e d u1 n o
ciascuna	tSS a s k u1 n a
ciascuno	tSS a s k u1 n o
ciascun	tSS a s k u1 n
cibi	tSS i1 b i
cibo	tSS i1 b o
cicerone	tSS i tSS e r o1 n e
ciciliana	tSS i tSS i l j a1 n a
ciciliani	tSS i tSS i l j a1 n i
ciclope	tSS i k l OO p e
ciclopi	tSS i k l OO p i
cicogna	tSS i k o1 JJ JJ a
cieca	tSS EE k a
ciechi	tSS EE k i
cieco	tSS EE k o
cieli	tSS EE l i
cielo	tSS EE l o
cigno	tSS i1 JJ JJ o
cima	tSS i1 m a
cime	tSS i1 m e
cinghiale	tSS i ng g j a1 l e
cino	tSS i1 n o
cinquanta	tSS i ng k w a1 n t a
cinquecento	tSS i ng k w e tSS EE n t o
cinque	tSS i1 ng k w e
cinta	tSS i1 n t a
cintola	tSS i1 n t o l a
cintura	tSS i n t u1 r a
cioè	tSS o EE
ciò	tSS OO
cipolla	tSS i p o1 l l a
circa	tSS i1 r k a
circolo	tSS i1 r k o l o
circondato	tSS i r k o n d a1 t o
circonda	tSS i r k o1 n d a
circonvicini	tSS i r k o nf v i tSS i1 n i
circostanze	tSS i r k o s t a1 n ts e
circuito	tSS i r k u i1 t o
cisti	tSS i1 s t i
ci	tSS i1
cittade	tSS i t t a1 d e
cittadini	tSS i t t a d i1 n i
cittadino	tSS i t t a d i1 n o
cittadi	tSS i t t a1 d i
città	tSS i t t a1
civile	tSS i v i1 l e
civili	tSS i v i1 l i
civiltà	tSS i v i l t a1
c	k
claudio	k l a1 u d j o
clelia	k l EE l j a
clori	k l OO r i
cocenti	k o tSS EE n t i
coda	k o1 d a
codesto	k o d e1 s t o
codice	k OO d i tSS e
cogliendo	k o LL LL EE n d o
cogliere	k OO LL LL e r e
cogli	k OO LL LL i
cognati	k o JJ JJ a1 t i
cognome	k o JJ JJ o1 m e
coi	k o1 i
colà	k o l a1
colei	k o l EE i
col	k o1 l
collaborare	k o l l a b o r a1 r e
colla	k o1 l l a
colle	k o1 l l e
colli	k OO l l i
collo	k OO l l o
colmo	k o1 l m o
colonna	k o l OO n n a
colore	k o l o1 r e
colori	k o l o1 r i
coloro	k o l o1 r o
colpa	k o1 l p a
colpe	k o1 l p e
colpevole	k o l p e1 v o l e
colpevoli	k o l p e1 v o l i
colpi	k o1 l p i
colpita	k o l p i1 t a
colpo	k o1 l p o
coltello	k o l t EE l l o
colto	k OO l t o
colui	k o l u1 i
comanda	k o m a1 n d a
comandamenti	k o m a n d a m e1 n t i
comandamento	k o m a n d a m e1 n t o
comandando	k o m a n d a1 n d o
comandasse	k o m a n d a1 s s e
comandato	k o m a n d a1 t o
comandò	k o m a n d OO
comare	k o m a1 r e
combattendo	k o m b a t t EE n d o
combattenti	k o m b a t t EE n t i
combattere	k o m b a1 t t e r e
combattuto	k o m b a t t u1 t o
come	k o1 m e
comici	k OO m i tSS i
cominciai	k o m i n tSS a1 i
comincia	k o m i1 n tSS a
cominciando	k o m i n tSS a1 n d o
cominciare	k o m i n tSS a1 r e
cominciarono	k o m i n tSS a1 r o n o
cominciata	k o m i n tSS a1 t a
cominciate	k o m i n tSS a1 t e
cominciato	k o m i n tSS a1 t o
cominciava	k o m i n tSS a1 v a
cominciò	k o m i n tSS OO
com	k o1 m
commendare	k o m m e n d a1 r e
commendata	k o m m e n d a1 t a
commendato	k o m m e n d a1 t o
commendò	k o m m e n d OO
commenti	k o m m e1 n t i
commessa	k o m m e1 s s a
commesse	k o m m e1 s s e
commesso	k o m m e1 s s o
commette	k o m m e1 t t e
commettere	k o m m e1 t t e r e
commiato	k o m m j a1 t o
commise	k o m m i1 z e
commisi	k o m m i1 z i
commossa	k o m m OO s s a
commosse	k o m m OO s s e
commossi	k o m m OO s s i
commosso	k o m m OO s s o
commovente	k o m m o v EE n t e
commune	k o m m u1 n e
communi	k o m m u1 n i
commuovere	k o m m w OO v e r e
compagna	k o m p a1 JJ JJ a
compagne	k o m p a1 JJ JJ e
compagnia	k o m p a JJ JJ i1 a
compagni	k o m p a1 JJ JJ i
compagno	k o m p a1 JJ JJ o
comparazione	k o m p a r a ts ts j o1 n e
compare	k o m p a1 r e
comparire	k o m p a r i1 r e
comparse	k o m p a1 r s e
compassione	k o m p a s s j o1 n e
comperata	k o m p e r a1 t a
comperazione	k o m p e r a ts ts j o1 n e
compiacere	k o m p j a tSS e1 r e
compie	k o1 m p j e
compiere	k o1 m p j e r e
compimento	k o m p i m e1 n t o
compiuta	k o m p j u1 t a
compiutamente	k o m p j u t a m e1 n t e
compiute	k o m p j u1 t e
compiuto	k o m p j u1 t o
complessione	k o m p l e s s j o1 n e
complesso	k o m p l EE s s o
completamente	k o m p l e t a m e1 n t e
componendo	k o m p o n EE n d o
componimenti	k o m p o n i m e1 n t i
comporre	k o m p o1 r r e
comportare	k o m p o r t a1 r e
compose	k o m p o1 s e
composizione	k o m p o z i ts ts j o1 n e
composizioni	k o m p o z i ts ts j o1 n i
composta	k o m p o1 s t a
composte	k o m p o1 s t e
composti	k o m p o1 s t i
composto	k o m p o1 s t o
comprenda	k o m p r EE n d a
comprende	k o m p r EE n d e
comprendendo	k o m p r e n d EE n d o
comprendere	k o m p r EE n d e r e
comprendeva	k o m p r e n d e1 v a
comprendo	k o m p r EE n d o
compresa	k o m p r e1 s a
comprese	k o m p r e1 s e
compresi	k o m p r e1 s i
compreso	k o m p r e1 s o
comune	k o m u1 n e
comunemente	k o m u n e m e1 n t e
comuni	k o m u1 n i
comunque	k o m u1 ng k w e
conceda	k o n tSS EE d a
concedano	k o n tSS EE d a n o
concede	k o n tSS EE d e
concedendo	k o n tSS e d EE n d o
concederà	k o n tSS e d e r a1
concedere	k o n tSS EE d e r e
concedesse	k o n tSS e d e1 s s e
concedette	k o n tSS e d EE t t e
concedi	k o n tSS EE d i
concedono	k o n tSS EE d o n o
conceduta	k o n tSS e d u1 t a
concedute	k o n tSS e d u1 t e
conceduto	k o n tSS e d u1 t o
concento	k o n tSS EE n t o
concesse	k o n tSS EE s s e
concesso	k o n tSS EE s s o
concetto	k o n tSS EE t t o
conchiudendo	k o ng k j u d EE n d o
conchiudere	k o ng k j u1 d e r e
conchiuse	k o ng k j u1 s e
conchiuso	k o ng k j u1 s o
conclusione	k o ng k l u z j o1 n e
conclusioni	k o ng k l u z j o1 n i
concordia	k o ng k OO r d j a
concorso	k o ng k o1 r s o
concupiscenza	k o ng k u p i SS SS EE n ts a
concupiscevole	k o ng k u p i SS SS e1 v o l e
condannare	k o n d a n n a1 r e
condannata	k o n d a n n a1 t a
condannati	k o n d a n n a1 t i
condannato	k o n d a n n a1 t o
condividi	k o n d i v i1 d i
condizionalmente	k o n d i ts ts j o n a l m e1 n t e
condizione	k o n d i ts ts j o1 n e
condizioni	k o n d i ts ts j o1 n i
condotta	k o n d o1 t t a
condotti	k o n d o1 t t i
condotto	k o n d o1 t t o
conduca	k o n d u1 k a
conducesse	k o n d u tSS e1 s s e
condurre	k o n d u1 r r e
condusse	k o n d u1 s s e
conferma	k o nf f e1 r m a
confermato	k o nf f e r m a1 t o
confessa	k o nf f EE s s a
confessando	k o nf f e s s a1 n d o
confessare	k o nf f e s s a1 r e
confessato	k o nf f e s s a1 t o
confessione	k o nf f e s s j o1 n e
confesso	k o nf f EE s s o
confessò	k o nf f e s s OO
confetti	k o nf f EE t t i
confinato	k o nf f i n a1 t o
confini	k o nf f i1 n i
conforme	k o nf f o1 r m e
conformi	k o nf f o1 r m i
conformità	k o nf f o r m i t a1
conforta	k o nf f OO r t a
confortare	k o nf f o r t a1 r e
confortati	k o nf f o r t a1 t i
confortava	k o nf f o r t a1 v a
conforti	k o nf f OO r t i
conforto	k o nf f OO r t o
confortò	k o nf f o r t OO
confusa	k o nf f u1 z a
confusione	k o nf f u z j o1 n e
congedo	k o n dZZ EE d o
congiunge	k o n dZZ u1 n dZZ e
congiungere	k o n dZZ u1 n dZZ e r e
congiungimenti	k o n dZZ u n dZZ i m e1 n t i
congiungimento	k o n dZZ u n dZZ i m e1 n t o
congiunse	k o n dZZ u1 n s e
congiunta	k o n dZZ u1 n t a
congiunte	k o n dZZ u1 n t e
congiunti	k o n dZZ u1 n t i
congiunto	k o n dZZ u1 n t o
con	k o1 n
conobbe	k o n o1 b b e
conobbero	k o n o1 b b e r o
conobbi	k o n o1 b b i
conosca	k o n o1 s k a
conosce	k o n o1 SS SS e
conoscendo	k o n o SS SS EE n d o
conoscente	k o n o SS SS EE n t e
conoscenti	k o n o SS SS EE n t i
conoscenza	k o n o SS SS EE n ts a
conoscerai	k o n o SS SS e r a1 i
conoscerà	k o n o SS SS e r a1
conoscere	k o n o1 SS SS e r e
conoscesse	k o n o SS SS e1 s s e
conoscessi	k o n o SS SS e1 s s i
conoscete	k o n o SS SS e1 t e
conosceva	k o n o SS SS e1 v a
conosciamo	k o n o SS SS a1 m o
conosciate	k o n o SS SS a1 t e
conosci	k o n o1 SS SS i
conosciuta	k o n o SS SS u1 t a
conosciute	k o n o SS SS u1 t e
conosciuti	k o n o SS SS u1 t i
conosciuto	k o n o SS SS u1 t o
conosco	k o n o1 s k o
conoscono	k o n o1 s k o n o
consacrato	k o n s a k r a1 t o
consapevole	k o n s a p e1 v o l e
consapevoli	k o n s a p e1 v o l i
conseguente	k o n s e g w EE n t e
conseguenza	k o n s e g w EE n ts a
conseguenze	k o n s e g w EE n ts e
conseguire	k o n s e g w i1 r e
consente	k o n s EE n t e
consentì	k o n s e n t i1
consentimento	k o n s e n t i m e1 n t o
consentire	k o n s e n t i1 r e
consentito	k o n s e n t i1 t o
consequente	k o n s e k w EE n t e
conserva	k o n s e r v a1
considera	k o n s i1 d e r a
considerando	k o n s i d e r a1 n d o
considerare	k o n s i d e r a1 r e
considerata	k o n s i d e r a1 t a
considerate	k o n s i d e r a1 t e
considerato	k o n s i d e r a1 t o
considerava	k o n s i d e r a1 v a
considerazione	k o n s i d e r a ts ts j o1 n e
consideriamo	k o n s i d e r j a1 m o
consigliare	k o n s i LL LL a1 r e
consigliato	k o n s i LL LL a1 t o
consigli	k o n s i1 LL LL i
consiglio	k o n s i1 LL LL o
consiste	k o n s i1 s t e
consolare	k o n s o l a1 r e
consolata	k o n s o l a1 t a
consolato	k o n s o l a1 t o
consolazione	k o n s o l a ts ts j o1 n e
consonante	k o n s o n a1 n t e
consonanti	k o n s o n a1 n t i
conspetto	k o n s p EE t t o
consueto	k o n s u EE t o
consuetudine	k o n s u e t u1 d i n e
consumato	k o n s u m a1 t o
consumi	k o n s u1 m i
contadini	k o n t a d i1 n i
contado	k o n t a1 d o
contaminare	k o n t a m i n a1 r e
contegno	k o n t EE JJ JJ o
conte	k o1 n t e
contemporanei	k o n t e m p o r a1 n e i
contenga	k o n t EE ng g a
contengono	k o n t EE ng g o n o
contenta	k o n t EE n t a
contentare	k o n t e n t a1 r e
contentezza	k o n t e n t e1 ts ts a
contenti	k o n t EE n t i
contento	k o n t EE n t o
contenuto	k o n t e n u1 t o
contesa	k o n t e1 s a
contessa	k o n t e1 s s a
contessina	k o n t e s s i1 n a
contezza	k o n t e1 ts ts a
contiene	k o n t j EE n e
conti	k o1 n t i
continua	k o n t i1 n u a
continuamente	k o n t i n u a m e1 n t e
continuando	k o n t i n u a1 n d o
continuare	k o n t i n u a1 r e
continue	k o n t i1 n u e
continui	k o n t i1 n u i
continuo	k o n t i1 n u o
continuò	k o n t i n u OO
conto	k o1 n t o
contò	k o n t OO
contrada	k o n t r a1 d a
contraddizione	k o n t r a d d i ts ts j o1 n e
contrade	k o n t r a1 d e
contraria	k o n t r a1 r j a
contrarie	k o n t r a1 r j e
contrarietà	k o n t r a r j e t a1
contrarii	k o n t r a1 r j i
contrari	k o n t r a1 r i
contrario	k o n t r a1 r j o
contrastare	k o n t r a s t a1 r e
contrasto	k o n t r a1 s t o
contratto	k o n t r a1 t t o
contro	k o1 n t r o
convenevole	k o nf v e n e1 v o l e
convenevolezza	k o nf v e n e v o l e1 ts ts a
convenevoli	k o nf v e n e1 v o l i
convenevolmente	k o nf v e n e v o l m e1 n t e
convenga	k o nf v EE ng g a
convengono	k o nf v EE ng g o n o
convenia	k o nf v e n i1 a
convenisse	k o nf v e n i1 s s e
conveniva	k o nf v e n i1 v a
convenne	k o nf v e1 n n e
convenuto	k o nf v e n u1 t o
converrà	k o nf v e r r a1
converrebbe	k o nf v e r r EE b b e
converria	k o nf v e r r i1 a
conversa	k o nf v EE r s a
converse	k o nf v EE r s e
conversione	k o nf v e r s j o1 n e
converso	k o nf v EE r s o
convertì	k o nf v e r t i1
convertita	k o nf v e r t i1 t a
convertito	k o nf v e r t i1 t o
conviene	k o nf v i EE n e
convinzione	k o nf v i n ts j o1 n e
conviti	k o nf v i1 t i
convito	k o nf v i1 t o
coperta	k o p EE r t a
coperte	k o p EE r t e
coperti	k o p EE r t i
coperto	k o p EE r t o
copia	k OO p j a
copiosa	k o p j o1 s a
copioso	k o p j o1 s o
coppa	k o1 p p a
coprire	k o p r i1 r e
coraggio	k o r a1 dZZ dZZ o
corde	k OO r d e
cordoglio	k o r d OO LL LL o
coricò	k o r i k OO
corna	k o1 r n a
corni	k OO r n i
corno	k OO r n o
cornuta	k o r n u1 t a
corollario	k o r o l l a1 r j o
corona	k o r o1 n a
coronata	k o r o n a1 t a
coronato	k o r o n a1 t o
corone	k o r o1 n e
coronide	k o r OO n i d e
corpi	k OO r p i
corpo	k OO r p o
corporale	k o r p o r a1 l e
corporali	k o r p o r a1 l i
correa	k OO r r e a
correggere	k o r r EE dZZ dZZ e r e
corre	k OO r r e
correndo	k o r r EE n d o
corrente	k o r r EE n t e
correnti	k o r r EE n t i
correre	k o1 r r e r e
correva	k o r r e1 v a
corrono	k o1 r r o n o
corrotta	k o r r o1 t t a
corrotto	k o r r o1 t t o
corsa	k OO r s a
corsari	k o r s a1 r i
corse	k OO r s e
corsero	k o1 r s e r o
corsi	k OO r s i
corso	k OO r s o
corta	k o1 r t a
corteccia	k o r t e1 tSS tSS a
corte	k o1 r t e
cortese	k o r t e1 z e
cortesemente	k o r t e z e m e1 n t e
cortesia	k o r t e z i1 a
cortesi	k o r t e1 z i
cortigiana	k o r t i dZZ a1 n a
corti	k o1 r t i
cortile	k o r t i1 l e
corto	k o1 r t o
corvo	k OO r v o
cosa	k OO s a
coscia	k OO SS SS a
coscienza	k o SS SS EE n ts a
cose	k OO s e
cosi	k OO z i
così	k o s i1
cosmografia	k o z m o g r a f i1 a
cospetto	k o s p EE t t o
costa	k OO s t a
costà	k o s t a1
costante	k o s t a1 n t e
costantemente	k o s t a n t e m e1 n t e
costanza	k o s t a1 n ts a
costei	k o s t EE i
costì	k o s t i1
costituisce	k o s t i t u i1 SS SS e
costoro	k o s t o1 r o
costretta	k o s t r e1 t t a
costretti	k o s t r e1 t t i
costretto	k o s t r e1 t t o
costrinse	k o s t r i1 n s e
costruire	k o s t r u i1 r e
costruzione	k o s t r u ts ts j o1 n e
costui	k o s t u1 i
costumata	k o s t u m a1 t a
costumato	k o s t u m a1 t o
costume	k o s t u1 m e
costumi	k o s t u1 m i
cotale	k o t a1 l e
cotali	k o t a1 l i
cotante	k o t a1 n t e
cotanti	k o t a1 n t i
cotanto	k o t a1 n t o
cotesta	k o t e1 s t a
coteste	k o t e1 s t e
cotesti	k o t e1 s t i
cotesto	k o t e1 s t o
crea	k r EE a
creare	k r e a1 r e
creata	k r e a1 t a
create	k r e a1 t e
creati	k r e a1 t i
creato	k r e a1 t o
creatore	k r e a t o1 r e
creatura	k r e a t u1 r a
creature	k r e a t u1 r e
crebbe	k r e1 b b e
creda	k r e1 d a
credano	k r e1 d a n o
crede	k r e1 d e
credendo	k r e d EE n d o
crederei	k r e d e r EE i
credere	k r e1 d e r e
crederò	k r e d e r OO
credesse	k r e d e1 s s e
credessi	k r e d e1 s s i
credete	k r e d e1 t e
credette	k r e d EE t t e
credettero	k r e d EE t t e r o
credetti	k r e d EE t t i
credeva	k r e d e1 v a
credevano	k r e d e1 v a n o
credevi	k r e d e1 v i
crediamo	k r e d j a1 m o
crediate	k r e d j a1 t e
credibile	k r e d i1 b i l e
credi	k r e1 d i
credo	k r EE d o
credono	k r e1 d o n o
credute	k r e d u1 t e
creduto	k r e d u1 t o
cresce	k r e1 SS SS e
crescendo	k r e SS SS EE n d o
crescente	k r e SS SS EE n t e
crescere	k r e1 SS SS e r e
crescete	k r e SS SS e1 t e
cresciuta	k r e SS SS u1 t a
cresciuti	k r e SS SS u1 t i
cresciuto	k r e SS SS u1 t o
crescono	k r e1 s k o n o
creta	k r e1 t a
cretese	k r e t e1 s e
cretesi	k r e t e1 s i
crini	k r i1 n i
cristallo	k r i s t a1 l l o
cristiana	k r i s t j a1 n a
cristianesimo	k r i s t j a n e1 z i m o
cristiani	k r i s t j a1 n i
cristiano	k r i s t j a1 n o
cristo	k r i1 s t o
critica	k r i1 t i k a
crivello	k r i v EE l l o
croce	k r o1 tSS e
cromi	k r OO m i
crucciati	k r u tSS tSS a1 t i
crucciato	k r u tSS tSS a1 t o
cruccio	k r u1 tSS tSS o
cruda	k r u1 d a
crudele	k r u d EE l e
crudeli	k r u d EE l i
crudelissimo	k r u d e l i1 s s i m o
crudelmente	k r u d e l m e1 n t e
crudeltà	k r u d e l t a1
crudo	k r u1 d o
cucina	k u tSS i1 n a
cui	k u1 i
culla	k u1 l l a
culto	k u1 l t o
culturale	k u l t u r a1 l e
cuoco	k w OO k o
cuoio	k w OO j o
cuore	k w OO r e
cuori	k w OO r i
cupido	k u1 p i d o
cura	k u1 r a
curano	k u1 r a n o
curare	k u r a1 r e
curato	k u r a1 t o
curava	k u r a1 v a
cure	k u1 r e
curiosità	k u r j o s i t a1
curo	k u1 r o
curò	k u r OO
curva	k u1 r v a
custode	k u s t OO d e
custodia	k u s t OO d j a
da	d a1
dà	d a1
dagli	d a1 LL LL i
dai	d a1 i
dal	d a1 l
dalla	d a1 l l a
dalle	d a1 l l e
dalli	d a1 l l i
dallo	d a1 l l o
damigella	d a m i dZZ EE l l a
damigelle	d a m i dZZ EE l l e
danari	d a n a1 r i
dando	d a1 n d o
dannata	d a n n a1 t a
dannati	d a n n a1 t i
danni	d a1 n n i
danno	d a1 n n o
dannosa	d a n n o1 s a
dannosi	d a n n o1 s i
dannoso	d a n n o1 s o
dante	d a1 n t e
danza	d a1 n ts a
dardano	d a r d a1 n o
dardi	d a1 r d i
dardo	d a1 r d o
darebbe	d a r EE b b e
dare	d a1 r e
dargli	d a1 r LL i
dario	d a1 r j o
darti	d a1 r t i
dassi	d a1 s s i
data	d a1 t a
date	d a1 t e
dati	d a1 t i
dato	d a1 t o
dattorno	d a t t o1 r n o
dava	d a1 v a
davano	d a1 v a n o
davanti	d a v a1 n t i
davvero	d a v v e1 r o
d	d
dea	d EE a
debba	d EE b b a
debbano	d EE b b a n o
debbia	d EE b b j a
debbi	d EE b b i
debbo	d EE b b o
debbono	d EE b b o n o
debile	d EE b i l e
debita	d e1 b i t a
debitamente	d e b i t a m e1 n t e
debite	d e1 b i t e
debito	d e1 b i t o
debole	d e1 b o l e
debolezza	d e b o l e1 ts ts a
deboli	d e1 b o l i
decima	d EE tSS i m a
decimo	d EE tSS i m o
decisa	d e tSS i1 z a
declinare	d e k l i n a1 r e
decreto	d e k r e1 t o
dedalo	d EE d a l o
de	d e1
dedicata	d e d i k a1 t a
dedicato	d e d i k a1 t o
dee	d EE e
deggia	d EE dZZ dZZ a
degli	d e1 LL LL i
degna	d e1 JJ JJ a
degnamente	d e JJ JJ a m e1 n t e
degne	d e1 JJ JJ e
degni	d e1 JJ JJ i
degno	d e1 JJ JJ o
deh	d EE
dei	d EE i
deità	d e i t a1
del	d e1 l
delfino	d e l f i1 n o
delfo	d EE l f o
deliberato	d e l i b e r a1 t o
della	d e1 l l a
delle	d e1 l l e
dello	d e1 l l o
demoni	d EE m o n i
denari	d e n a1 r i
dente	d EE n t e
denti	d EE n t i
dentro	d e1 n t r o
deono	d EE o n o
deriva	d e r i1 v a
descritta	d e s k r i1 t t a
descritto	d e s k r i1 t t o
descrive	d e s k r i1 v e
descrivendo	d e s k r i v EE n d o
descrivere	d e s k r i1 v e r e
desiderando	d e s i d e r a1 n d o
desiderano	d e s i1 d e r a n o
desiderare	d e s i d e r a1 r e
desiderato	d e s i d e r a1 t o
desiderava	d e s i d e r a1 v a
desideri	d e s i d EE r i
desiderio	d e s i d EE r j o
desideroso	d e s i d e r o1 s o
designare	d e s i JJ JJ a1 r e
desinare	d e z i n a1 r e
desinato	d e z i n a1 t o
desio	d e z i1 o
desse	d e1 s s e
dessero	d e1 s s e r o
destare	d e s t a1 r e
destati	d e s t a1 t i
desti	d e1 s t i
destino	d e s t i1 n o
desto	d e1 s t o
destò	d e s t OO
destra	d EE s t r a
destre	d EE s t r e
destriere	d e s t r j EE r e
destro	d EE s t r o
determinata	d e t e r m i n a1 t a
determinato	d e t e r m i n a1 t o
detta	d e1 t t a
dette	d e1 t t e
detti	d e1 t t i
detto	d e1 t t o
deve	d EE v e
deversi	d e v EE r s i
devo	d EE v o
dia	d i1 a
dialettica	d i a l EE t t i k a
dialogo	d i a1 l o g o
diana	d j a1 n a
diano	d i1 a n o
dianzi	d j a1 n ts i
diate	d j a1 t e
diavolo	d j a1 v o l o
dica	d i1 k a
dicano	d i1 k a n o
dice	d i1 tSS e
dicembre	d i tSS EE m b r e
dicemmo	d i tSS e1 m m o
dicendo	d i tSS EE n d o
dicesse	d i tSS e1 s s e
dicessero	d i tSS e1 s s e r o
dicessi	d i tSS e1 s s i
diceste	d i tSS e1 s t e
dicesti	d i tSS e1 s t i
diceva	d i tSS e1 v a
dicevano	d i tSS e1 v a n o
dicevi	d i tSS e1 v i
dichiarare	d i k j a r a1 r e
dichiarata	d i k j a r a1 t a
dichiarate	d i k j a r a1 t e
dichiarato	d i k j a r a1 t o
dichiarazione	d i k j a r a ts ts j o1 n e
dichi	d i1 k i
diciamo	d i tSS a1 m o
diciate	d i tSS a1 t e
dici	d i1 tSS i
dico	d i1 k o
dicono	d i1 k o n o
di	d i1
dì	d i1
diece	d j EE tSS e
dieci	d j EE tSS i
diede	d j EE d e
diedero	d j EE d e r o
die	d i1 e
dietro	d j EE t r o
difendere	d i f EE n d e r e
difenditore	d i f e n d i t o1 r e
difesa	d i f e1 s a
difese	d i f e1 s e
difeso	d i f e1 s o
difetti	d i f EE t t i
difetto	d i f EE t t o
differente	d i f f e r EE n t e
differenti	d i f f e r EE n t i
differenza	d i f f e r EE n ts a
differenze	d i f f e r EE n ts e
difficile	d i f f i1 tSS i l e
difficoltà	d i f f i k o l t a1
difficultà	d i f f i k u l t a1
diffusamente	d i f f u z a m e1 n t e
diffusione	d i f f u z j o1 n e
digiunare	d i dZZ u n a1 r e
digiuni	d i dZZ u1 n i
digiuno	d i dZZ u1 n o
dignità	d i JJ JJ i t a1
diletta	d i l EE t t a
dilettano	d i l EE t t a n o
dilettare	d i l e t t a1 r e
dilettato	d i l e t t a1 t o
dilettava	d i l e t t a1 v a
dilettevole	d i l e t t e1 v o l e
dilettevoli	d i l e t t e1 v o l i
diletti	d i l EE t t i
diletto	d i l EE t t o
diliberato	d i l i b e r a1 t o
diligente	d i l i dZZ EE n t e
diligentemente	d i l i dZZ e n t e m e1 n t e
dilungatosi	d i l u ng g a t o1 z i
diluvio	d i l u1 v j o
dimenticando	d i m e n t i k a1 n d o
dimenticare	d i m e n t i k a1 r e
dimenticata	d i m e n t i k a1 t a
dimenticato	d i m e n t i k a1 t o
dimentichi	d i m e1 n t i k i
dimestichezza	d i m e s t i k e1 ts ts a
dimora	d i m OO r a
dimorando	d i m o r a1 n d o
dimorano	d i m OO r a n o
dimorante	d i m o r a1 n t e
dimorare	d i m o r a1 r e
dimorarono	d i m o r a1 r o n o
dimorasse	d i m o r a1 s s e
dimorata	d i m o r a1 t a
dimorate	d i m o r a1 t e
dimorati	d i m o r a1 t i
dimorato	d i m o r a1 t o
dimorava	d i m o r a1 v a
dimoravano	d i m o r a1 v a n o
dimorerò	d i m o r e r OO
dimoriamo	d i m o r j a1 m o
dimori	d i m OO r i
dimoro	d i m OO r o
dimorò	d i m o r OO
dimostra	d i m o1 s t r a
dimostrando	d i m o s t r a1 n d o
dimostrano	d i m o1 s t r a n o
dimostrare	d i m o s t r a1 r e
dimostrasse	d i m o s t r a1 s s e
dimostrata	d i m o s t r a1 t a
dimostrato	d i m o s t r a1 t o
dimostrava	d i m o s t r a1 v a
dimostrazione	d i m o s t r a ts ts j o1 n e
dimostrerà	d i m o s t r e r a1
dimostri	d i m o1 s t r i
dimostrò	d i m o s t r OO
dinanzi	d i n a1 n ts i
dintorno	d i n t o1 r n o
dio	d i1 o
dionigi	d j o n i1 dZZ i
dionisio	d j o n i1 z j o
dipignere	d i p i1 JJ JJ e r e
dipinta	d i p i1 n t a
dipinto	d i p i1 n t o
dipintore	d i p i n t o1 r e
dipinture	d i p i n t u1 r e
diporto	d i p OO r t o
dirà	d i r a1
dirai	d i r a1 i
diranno	d i r a1 n n o
dirce	d i1 r tSS e
direbbe	d i r EE b b e
dire	d i1 r e
direi	d i r EE i
diremo	d i r e1 m o
diretta	d i r EE t t a
dirimpetto	d i r i m p EE t t o
diritta	d i r i1 t t a
dirittamente	d i r i t t a m e1 n t e
diritti	d i r i1 t t i
diritto	d i r i1 t t o
dirizzare	d i r i ts ts a1 r e
dirizzata	d i r i ts ts a1 t a
dirizzò	d i r i ts ts OO
dirò	d i r OO
disagio	d i z a1 dZZ o
disarmato	d i z a r m a1 t o
disavventura	d i z a v v e n t u1 r a
discende	d i SS SS e1 n d e
discendendo	d i SS SS e n d EE n d o
discendenti	d i SS SS e n d EE n t i
discendenza	d i SS SS e n d EE n ts a
discendere	d i SS SS e1 n d e r e
discepoli	d i SS SS e1 p o l i
discepolo	d i SS SS e1 p o l o
discesa	d i SS SS e1 s a
discese	d i SS SS e1 s e
discesi	d i SS SS e1 s i
disceso	d i SS SS e1 s o
disciplina	d i SS SS i p l i1 n a
discorda	d i s k OO r d a
discordano	d i s k OO r d a n o
discordanti	d i s k o r d a1 n t i
discordia	d i s k OO r d j a
discordi	d i s k OO r d i
discorrendo	d i s k o r r EE n d o
discorrere	d i s k o1 r r e r e
discorsi	d i s k o1 r s i
discorso	d i s k o1 r s o
discreta	d i s k r EE t a
discretamente	d i s k r e t a m e1 n t e
discreti	d i s k r EE t i
discreto	d i s k r EE t o
discrezione	d i s k r e ts ts j o1 n e
discussione	d i s k u s s j o1 n e
disegna	d i s e1 JJ JJ a
disegnare	d i s e JJ JJ a1 r e
disegno	d i s e1 JJ JJ o
diserto	d i z EE r t o
disiato	d i z i a1 t o
disii	d i z i1 i
disio	d i z i1 o
disonesta	d i z o n EE s t a
disonesti	d i z o n EE s t i
disonesto	d i z o n EE s t o
disordinato	d i z o r d i n a1 t o
disparte	d i s p a1 r t e
disperata	d i s p e r a1 t a
disperato	d i s p e r a1 t o
dispersi	d i s p EE r s i
dispetto	d i s p EE t t o
dispiacere	d i s p j a tSS e1 r e
dispone	d i s p o1 n e
disponibili	d i s p o n i1 b i l i
disporre	d i s p o1 r r e
dispose	d i s p o1 s e
disposta	d i s p o1 s t a
disposte	d i s p o1 s t e
disposti	d i s p o1 s t i
disposto	d i s p o1 s t o
disprezzo	d i s p r EE ts ts o
disputando	d i s p u t a1 n d o
disputare	d i s p u t a1 r e
dispute	d i1 s p u t e
disse	d i1 s s e
dissero	d i1 s s e r o
dissi	d i1 s s i
distanza	d i s t a1 n ts a
distendere	d i s t EE n d e r e
distesa	d i s t e1 s a
distese	d i s t e1 s e
disteso	d i s t e1 s o
distribuito	d i s t r i b u i1 t o
distruzione	d i s t r u ts ts j o1 n e
disusata	d i z u z a1 t a
dita	d i1 t a
dite	d i1 t e
dito	d i1 t o
divenga	d i v EE ng g a
divenire	d i v e n i1 r e
divenisse	d i v e n i1 s s e
diventa	d i v EE n t a
diventano	d i v EE n t a n o
diventato	d i v e n t a1 t o
diventiamo	d i v e n t j a1 m o
diventò	d i v e n t OO
divenuta	d i v e n u1 t a
divenute	d i v e n u1 t e
divenuti	d i v e n u1 t i
divenuto	d i v e n u1 t o
diversa	d i v EE r s a
diversamente	d i v e r s a m e1 n t e
diverse	d i v EE r s e
diversi	d i v EE r s i
diversità	d i v e r s i t a1
diverso	d i v EE r s o
dividere	d i v i1 d e r e
diviene	d i v i EE n e
divina	d i v i1 n a
divine	d i v i1 n e
divini	d i v i1 n i
divinità	d i v i n i t a1
divino	d i v i1 n o
divisa	d i v i1 z a
divise	d i v i1 z e
divisi	d i v i1 z i
divisione	d i v i z j o1 n e
diviso	d i v i1 z o
divorato	d i v o r a1 t o
divota	d i v OO t a
divotamente	d i v o t a m e1 n t e
divoti	d i v OO t i
divoto	d i v OO t o
dobbiamo	d o b b j a1 m o
documenti	d o k u m e1 n t i
dodici	d o1 d i tSS i
do	d o1
dogana	d o g a1 n a
doglia	d OO LL LL a
doglie	d OO LL LL e
doglio	d OO LL LL o
dogma	d OO g m a
doi	d o1 i
dolce	d o1 l tSS e
dolcemente	d o l tSS e m e1 n t e
dolcezza	d o l tSS e1 ts ts a
dolcezze	d o l tSS e1 ts ts e
dolci	d o1 l tSS i
dolcissima	d o l tSS i1 s s i m a
dolcissime	d o l tSS i1 s s i m e
dolcissimi	d o l tSS i1 s s i m i
dolcissimo	d o l tSS i1 s s i m o
dolea	d o l e1 a
dolente	d o l EE n t e
dolenti	d o l EE n t i
dolere	d o l e1 r e
doleva	d o l e1 v a
dolga	d OO l g a
dolgo	d OO l g o
dolore	d o l o1 r e
dolori	d o l o1 r i
dolorosa	d o l o r o1 s a
dolorosamente	d o l o r o s a m e1 n t e
dolorose	d o l o r o1 s e
dolorosi	d o l o r o1 s i
doloroso	d o l o r o1 s o
doluta	d o l u1 t a
doluto	d o l u1 t o
domanda	d o m a1 n d a
domandando	d o m a n d a1 n d o
domandano	d o m a1 n d a n o
domandare	d o m a n d a1 r e
domandarono	d o m a n d a1 r o n o
domandata	d o m a n d a1 t a
domandate	d o m a n d a1 t e
domandato	d o m a n d a1 t o
domandava	d o m a n d a1 v a
domande	d o m a1 n d e
domanderò	d o m a n d e r OO
domandi	d o m a1 n d i
domando	d o m a1 n d o
domandò	d o m a n d OO
domane	d o m a1 n e
domani	d o m a1 n i
domattina	d o m a t t i1 n a
domeneddio	d o m e n e d d i1 o
domenica	d o m EE n i k a
domestica	d o m EE s t i k a
domestiche	d o m EE s t i k e
domestici	d o m EE s t i tSS i
domestico	d o m EE s t i k o
domine	d OO m i n e
dominio	d o m i1 n j o
dona	d o1 n a
donai	d o n a1 i
donare	d o n a1 r e
donasse	d o n a1 s s e
donata	d o n a1 t a
donate	d o n a1 t e
donati	d o n a1 t i
donato	d o n a1 t o
donatore	d o n a t o1 r e
donazione	d o n a ts ts j o1 n e
donde	d o1 n d e
don	d OO n
donerò	d o n e r OO
doni	d o1 n i
donna	d OO n n a
donne	d OO n n e
donno	d OO n n o
dono	d o1 n o
donò	d o n OO
donzella	d o n dz EE l l a
donzelle	d o n dz EE l l e
dopo	d o1 p o
doppia	d o1 p p j a
doppio	d o1 p p j o
doppo	d o1 p p o
dori	d OO r i
dorme	d OO r m e
dormendo	d o r m EE n d o
dormire	d o r m i1 r e
dormito	d o r m i1 t o
dormiva	d o r m i1 v a
dormono	d OO r m o n o
dosso	d OO s s o
dotata	d o t a1 t a
dotato	d o t a1 t o
dote	d OO t e
dotti	d OO t t i
dottissimi	d o t t i1 s s i m i
dottissimo	d o t t i1 s s i m o
dotto	d OO t t o
dottore	d o t t o1 r e
dottori	d o t t o1 r i
dottrina	d o t t r i1 n a
dottrine	d o t t r i1 n e
dovea	d o v e1 a
dove	d o1 v e
dovendo	d o v EE n d o
dovere	d o v e1 r e
doveri	d o v e1 r i
dovermi	d o v EE r m i
dovesse	d o v e1 s s e
dovessero	d o v e1 s s e r o
dovessi	d o v e1 s s i
dovete	d o v e1 t e
dovette	d o v EE t t e
doveva	d o v e1 v a
dovevano	d o v e1 v a n o
dovevi	d o v e1 v i
dovrà	d o v r a1
dovrebbe	d o v r EE b b e
dovrei	d o v r EE i
dovreste	d o v r e1 s t e
dovresti	d o v r e1 s t i
dovria	d o v r i1 a
dovunque	d o v u1 ng k w e
dovuta	d o v u1 t a
dovuto	d o v u1 t o
drappi	d r a1 p p i
drappo	d r a1 p p o
dritta	d r i1 t t a
dritti	d r i1 t t i
dritto	d r i1 t t o
drizzò	d r i ts ts OO
dubbi	d u1 b b i
dubbio	d u1 b b j o
dubbiosa	d u b b j o1 s a
dubbiosi	d u b b j o1 s i
dubbioso	d u b b j o1 s o
dubita	d u1 b i t a
dubitando	d u b i t a1 n d o
dubitare	d u b i t a1 r e
dubitate	d u b i t a1 t e
dubitava	d u b i t a1 v a
dubiti	d u1 b i t i
dubito	d u1 b i t o
dubitò	d u b i t OO
duca	d u1 k a
due	d u1 e
dugento	d u dZZ EE n t o
dum	d u1 m
dunque	d u1 ng k w e
duodecimo	d u o d EE tSS i m o
duo	d u1 o
duole	d w OO l e
duoli	d w OO l i
duolo	d w OO l o
dura	d u1 r a
duramente	d u r a m e1 n t e
durano	d u1 r a n o
durante	d u r a1 n t e
durare	d u r a1 r e
durasse	d u r a1 s s e
durata	d u r a1 t a
durato	d u r a1 t o
durava	d u r a1 v a
dure	d u1 r e
durerà	d u r e r a1
durevole	d u r e1 v o l e
durezza	d u r e1 ts ts a
duri	d u1 r i
duro	d u1 r o
durò	d u r OO
eaco	e a1 k o
ea	e1 a
ebbe	EE b b e
ebbene	e b b EE n e
ebbero	EE b b e r o
ebbi	EE b b i
ebbri	EE b b r i
ebbro	EE b b r o
eccellente	e tSS tSS e l l EE n t e
eccellenti	e tSS tSS e l l EE n t i
eccellenza	e tSS tSS e l l EE n ts a
eccelse	e tSS tSS EE l s e
eccelso	e tSS tSS EE l s o
eccetto	e tSS tSS EE t t o
ecco	EE k k o
ed	e1 d
edificare	e d i f i k a1 r e
edificarono	e d i f i k a1 r o n o
edificata	e d i f i k a1 t a
edificato	e d i f i k a1 t o
edifici	e d i f i1 tSS i
edificò	e d i f i k OO
editoria	e d i t o r i1 a
edizione	e d i ts ts j o1 n e
e	e1
è	e1
È	EE
effettuosamente	e f f e t t u o s a m e1 n t e
efficacia	e f f i k a1 tSS a
effigie	e f f i1 dZZ e
egisto	e dZZ i1 s t o
egitto	e dZZ i1 t t o
egli	e1 LL LL i
eguale	e g w a1 l e
eguali	e g w a1 l i
eh	EE
ei	EE i
el	e1 l
eleganza	e l e g a1 n ts a
eleggere	e l EE dZZ dZZ e r e
elementi	e l e m e1 n t i
elemento	e l e m e1 n t o
elena	EE l e n a
eletta	e l EE t t a
eletto	e l EE t t o
elettra	e l EE t t r a
elettronica	e l e t t r OO n i k a
elettronico	e l e t t r OO n i k o
elezione	e l e ts ts j o1 n e
ella	e1 l l a
elle	EE l l e
elli	e1 l l i
eloquenza	e l o k w EE n ts a
emilia	e m i1 l j a
eminente	e m i n EE n t e
empie	EE m p i e
empiono	EE m p j o n o
empito	e m p i1 t o
en	e1 n
enea	e n EE a
ennio	EE n n j o
entra	e1 n t r a
entrambi	e n t r a1 m b i
entrando	e n t r a1 n d o
entrano	e1 n t r a n o
entrare	e n t r a1 r e
entrarono	e n t r a1 r o n o
entrasse	e n t r a1 s s e
entrata	e n t r a1 t a
entrate	e n t r a1 t e
entrati	e n t r a1 t i
entrato	e n t r a1 t o
entrava	e n t r a1 v a
entri	e1 n t r i
entro	e1 n t r o
entrò	e n t r OO
eolo	EE o l o
era	EE r a
erano	EE r a n o
eravate	e r a v a1 t e
erba	EE r b a
erbe	EE r b e
ercolano	e r k o l a1 n o
ercole	EE r k o l e
erede	e r EE d e
eredità	e r e d i t a1
erice	EE r i tSS e
eri	EE r i
eritreo	e r i t r EE o
ero	EE r o
eroi	e r OO i
errando	e r r a1 n d o
errare	e r r a1 r e
errore	e r r o1 r e
errori	e r r o1 r i
esca	EE s k a
esce	EE SS SS e
esclamò	e s k l a m OO
escono	EE s k o n o
es	EE s
esemplare	e z e m p l a1 r e
esilio	e z i1 l j o
esistenza	e z i s t EE n ts a
esitanze	e z i t a1 n ts e
espansione	e s p a n s j o1 n e
esperienza	e s p e r j EE n ts a
esperienzia	e s p e r j EE n ts j a
esporre	e s p o1 r r e
esposta	e s p o1 s t a
esposto	e s p o1 s t o
espressione	e s p r e s s j o1 n e
esprimere	e s p r i1 m e r e
essa	e1 s s a
esse	EE s s e
essendo	e s s EE n d o
essere	EE s s e r e
essi	e1 s s i
essilio	e s s i1 l j o
esso	e1 s s o
est	EE s t
esteriori	e s t e r j o1 r i
estimando	e s t i m a1 n d o
estimava	e s t i m a1 v a
estimo	e s t i1 m o
estimò	e s t i m OO
estinto	e s t i1 n t o
estravaganti	e s t r a v a g a1 n t i
estrema	e s t r EE m a
estremi	e s t r EE m i
estremo	e s t r EE m o
et	e1 t
eterna	e t EE r n a
eternità	e t e r n i t a1
eterno	e t EE r n o
etica	EE t i k a
etico	EE t i k o
etterni	e t t EE r n i
etterno	e t t EE r n o
euro	EE u r o
europa	e u r OO p a
eusebio	e u z EE b j o
evandro	e v a1 n d r o
evidente	e v i d EE n t e
evidenza	e v i d EE n ts a
evo	EE v o
ex	EE k s
faccende	f a tSS tSS EE n d e
faccendo	f a tSS tSS EE n d o
faccendosi	f a tSS tSS e n d o1 s i
faccia	f a1 tSS tSS a
facciamo	f a tSS tSS a1 m o
facciano	f a1 tSS tSS a n o
facciate	f a tSS tSS a1 t e
facci	f a1 tSS tSS i
faccio	f a1 tSS tSS o
face	f a1 tSS e
facendo	f a tSS EE n d o
facesse	f a tSS e1 s s e
facessero	f a tSS e1 s s e r o
facessi	f a tSS e1 s s i
faceste	f a tSS e1 s t e
facesti	f a tSS e1 s t i
faceva	f a tSS e1 v a
facevano	f a tSS e1 v a n o
facile	f a1 tSS i l e
facili	f a1 tSS i l i
facilmente	f a tSS i l m e1 n t e
facondia	f a k o1 n d j a
facultà	f a k u l t a1
fa	f a1
fagiana	f a dZZ a1 n a
fai	f a1 i
falce	f a1 l tSS e
falcone	f a l k o1 n e
fallace	f a l l a1 tSS e
falla	f a1 l l a
falli	f a1 l l i
fallire	f a l l i1 r e
fallo	f a1 l l o
falsa	f a1 l s a
falsamente	f a l s a m e1 n t e
false	f a1 l s e
falsi	f a1 l s i
falsità	f a l s i t a1
falso	f a1 l s o
fama	f a1 m a
fame	f a1 m e
famiglia	f a m i1 LL LL a
famigliare	f a m i LL LL a1 r e
famigliari	f a m i LL LL a1 r i
famiglie	f a m i1 LL LL e
famiglio	f a m i1 LL LL o
famosa	f a m o1 s a
famose	f a m o1 s e
famosi	f a m o1 s i
famosissima	f a m o s i1 s s i m a
famosissimi	f a m o s i1 s s i m i
famosissimo	f a m o s i1 s s i m o
famoso	f a m o1 s o
fanciulla	f a n tSS u1 l l a
fanciulle	f a n tSS u1 l l e
fanciullezza	f a n tSS u l l e1 ts ts a
fanciulli	f a n tSS u1 l l i
fanciullo	f a n tSS u1 l l o
fango	f a1 ng g o
fanno	f a1 n n o
fantasia	f a n t a z i1 a
fante	f a1 n t e
fanti	f a1 n t i
farai	f a r a1 i
faranno	f a r a1 n n o
farci	f a1 r tSS i
farebbe	f a r EE b b e
fare	f a1 r e
farei	f a r EE i
faremo	f a r e1 m o
fareste	f a r e1 s t e
faresti	f a r e1 s t i
farete	f a r e1 t e
farsetto	f a r s e1 t t o
fascio	f a1 SS SS o
fasi	f a1 z i
fassi	f a1 s s i
fastidio	f a s t i1 d j o
fatale	f a t a1 l e
fate	f a1 t e
fatica	f a t i1 k a
fatiche	f a t i1 k e
fati	f a1 t i
fato	f a1 t o
fatta	f a1 t t a
fattamente	f a t t a m e1 n t e
fatte	f a1 t t e
fattezze	f a t t e1 ts ts e
fatti	f a1 t t i
fatto	f a1 t t o
fattore	f a t t o1 r e
fatua	f a1 t u a
fauci	f a1 u tSS i
fauna	f a1 u n a
fauni	f a1 u n i
fauno	f a1 u n o
favella	f a v EE l l a
favellando	f a v e l l a1 n d o
favellare	f a v e l l a1 r e
favelle	f a v EE l l e
favilla	f a v i1 l l a
faville	f a v i1 l l e
favola	f a1 v o l a
favole	f a1 v o l e
favolosa	f a v o l o1 s a
favolosi	f a v o l o1 s i
favoloso	f a v o l o1 s o
favore	f a v o1 r e
favorevole	f a v o r e1 v o l e
favorevoli	f a v o r e1 v o l i
favorisce	f a v o r i1 SS SS e
favorito	f a v o r i1 t o
febbre	f EE b b r e
feccia	f EE tSS tSS a
fece	f e1 tSS e
fecero	f e1 tSS e r o
feci	f EE tSS i
fede	f e1 d e
fedele	f e d e1 l e
fedel	f e d e1 l
fedeli	f e d e1 l i
fedelissimo	f e d e l i1 s s i m o
fedelmente	f e d e l m e1 n t e
federazione	f e d e r a ts ts j o1 n e
federigo	f e d e r i1 g o
fe	f e1
fé	f e1
felice	f e l i1 tSS e
felicemente	f e l i tSS e m e1 n t e
felici	f e l i1 tSS i
felicità	f e l i tSS i t a1
fenici	f e n i1 tSS i
fera	f EE r a
ferendo	f e r EE n d o
ferì	f e r i1
ferire	f e r i1 r e
ferita	f e r i1 t a
ferite	f e r i1 t e
feriti	f e r i1 t i
ferito	f e r i1 t o
ferma	f e1 r m a
fermamente	f e r m a m e1 n t e
fermare	f e r m a1 r e
fermarono	f e r m a1 r o n o
fermata	f e r m a1 t a
fermati	f e r m a1 t i
fermato	f e r m a1 t o
ferme	f e1 r m e
fermezza	f e r m e1 ts ts a
fermi	f e1 r m i
fermo	f EE r m o
fermò	f e r m OO
feroce	f e r o1 tSS e
feroci	f e r o1 tSS i
ferocissimo	f e r o tSS i1 s s i m o
ferrara	f e r r a1 r a
ferri	f EE r r i
ferro	f EE r r o
fertile	f EE r t i l e
fervente	f e r v EE n t e
ferventemente	f e r v e n t e m e1 n t e
ferventissimo	f e r v e n t i1 s s i m o
fervore	f e r v o1 r e
fessure	f e s s u1 r e
festa	f EE s t a
feste	f EE s t e
festeggiare	f e s t e dZZ dZZ a1 r e
festevole	f e s t e1 v o l e
f	f
fia	f i1 a
fiamma	f j a1 m m a
fiammetta	f j a m m e1 t t a
fianchi	f j a1 ng k i
fianco	f j a1 ng k o
fiasco	f j a1 s k o
fiata	f j a1 t a
fiate	f j a1 t e
fiato	f j a1 t o
fida	f i1 d a
fidanza	f i d a1 n ts a
fidava	f i d a1 v a
fido	f i1 d o
fie	f i1 e
fieno	f j EE n o
fiera	f j EE r a
fieramente	f j e r a m e1 n t e
fiere	f j EE r e
fierezza	f j e r e1 ts ts a
fieri	f j EE r i
fiero	f j EE r o
fievole	f j EE v o l e
figlia	f i1 LL LL a
figli	f i1 LL LL i
figlio	f i1 LL LL o
figlioli	f i LL LL OO l i
figliolo	f i LL LL OO l o
figliuola	f i LL LL w OO l a
figmenti	f i g m e1 n t i
figmento	f i g m e1 n t o
figura	f i g u1 r a
figurato	f i g u r a1 t o
figure	f i g u1 r e
fila	f i1 l a
fili	f i1 l i
filippo	f i l i1 p p o
filo	f i1 l o
filomena	f i l o m EE n a
filosofanti	f i l o z o f a1 n t i
filosofia	f i l o z o f i1 a
filosofica	f i l o z OO f i k a
filosofico	f i l o z OO f i k o
filosofi	f i l OO z o f i
filosofo	f i l OO z o f o
finale	f i n a1 l e
finalità	f i n a l i t a1
finalmente	f i n a l m e1 n t e
fine	f i1 n e
finestra	f i n EE s t r a
finestre	f i n EE s t r e
finge	f i1 n dZZ e
fingendo	f i n dZZ EE n d o
fingere	f i1 n dZZ e r e
fingono	f i1 ng g o n o
fini	f i1 n i
finì	f i n i1
finire	f i n i1 r e
finisce	f i n i1 SS SS e
finiscono	f i n i1 s k o n o
finisse	f i n i1 s s e
finita	f i n i1 t a
finite	f i n i1 t e
finito	f i n i1 t o
fino	f i1 n o
finsero	f i1 n s e r o
finta	f i1 n t a
finto	f i1 n t o
fiore	f j o1 r e
fiorentina	f j o r e n t i1 n a
fiorentini	f j o r e n t i1 n i
fiorentino	f j o r e n t i1 n o
fiorenza	f j o r EE n ts a
fiori	f j o1 r i
fiorin	f j o r i1 n
fiorini	f j o r i1 n i
firenze	f i r EE n ts e
fisica	f i1 z i k a
fisici	f i1 z i tSS i
fiso	f i1 z o
fissi	f i1 s s i
fisso	f i1 s s o
fissò	f i s s OO
fistola	f i1 s t o l a
fitone	f i t o1 n e
fiume	f j u1 m e
fiumi	f j u1 m i
flora	f l OO r a
florio	f l OO r j o
foci	f o1 tSS i
foco	f OO k o
focosamente	f o k o s a m e1 n t e
focosi	f o k o1 s i
focoso	f o k o1 s o
fo	f OO
foga	f o1 g a
foglie	f OO LL LL e
foglio	f OO LL LL o
folco	f o1 l k o
folgore	f o1 l g o r e
folgori	f o1 l g o r i
folla	f o1 l l a
folle	f OO l l e
follia	f o l l i1 a
folli	f OO l l i
folta	f o1 l t a
fondaco	f o1 n d a k o
fondamentale	f o n d a m e n t a1 l e
fondamenti	f o n d a m e1 n t i
fondamento	f o n d a m e1 n t o
fondatori	f o n d a t o1 r i
fondo	f o1 n d o
fontana	f o n t a1 n a
fontane	f o n t a1 n e
fora	f OO r a
forche	f o1 r k e
forese	f o r e1 s e
forestiere	f o r e s t j EE r e
forestieri	f o r e s t j EE r i
forma	f o1 r m a
formale	f o r m a1 l e
formano	f o1 r m a n o
formare	f o r m a1 r e
formata	f o r m a1 t a
formato	f o r m a1 t o
forme	f o1 r m e
formiche	f o r m i1 k e
formò	f o r m OO
formula	f OO r m u l a
fornaio	f o r n a1 j o
fornire	f o r n i1 r e
fornita	f o r n i1 t a
fornito	f o r n i1 t o
forse	f o1 r s e
forte	f OO r t e
fortemente	f o r t e m e1 n t e
fortezza	f o r t e1 ts ts a
forti	f OO r t i
fortissima	f o r t i1 s s i m a
fortissimi	f o r t i1 s s i m i
fortissimo	f o r t i1 s s i m o
fortuna	f o r t u1 n a
fortune	f o r t u1 n e
fortunosi	f o r t u n o1 s i
forza	f OO r ts a
forze	f OO r ts e
fossa	f OO s s a
fosse	f OO s s e
fossero	f o1 s s e r o
fossi	f OO s s i
fossimo	f o1 s s i m o
foste	f o1 s t e
fosti	f o1 s t i
fra	f r a1
fragilità	f r a dZZ i l i t a1
frale	f r a1 l e
francesca	f r a n tSS e1 s k a
francesco	f r a n tSS e1 s k o
francese	f r a n tSS e1 z e
francia	f r a1 n tSS a
frase	f r a1 z e
frasi	f r a1 z i
frate	f r a1 t e
fratelli	f r a t EE l l i
fratello	f r a t EE l l o
fredda	f r e1 d d a
fredde	f r e1 d d e
freddezza	f r e d d e1 ts ts a
freddi	f r e1 d d i
freddo	f r e1 d d o
fremito	f r EE m i t o
freni	f r EE n i
freno	f r EE n o
fresca	f r e1 s k a
fresche	f r e1 s k e
freschi	f r e1 s k i
fresco	f r e1 s k o
fretta	f r e1 t t a
frigia	f r i1 dZZ a
frigidità	f r i dZZ i d i t a1
friso	f r i1 z o
friuli	f r i u1 l i
frode	f r OO d e
fronda	f r o1 n d a
fronde	f r o1 n d e
frondi	f r o1 n d i
fronte	f r o1 n t e
frutti	f r u1 t t i
frutto	f r u1 t t o
fù	f u1
fuga	f u1 g a
fugga	f u1 g g a
fugge	f u1 dZZ dZZ e
fuggendo	f u dZZ dZZ EE n d o
fuggì	f u dZZ dZZ i1
fuggire	f u dZZ dZZ i1 r e
fuggirono	f u dZZ dZZ i1 r o n o
fuggisse	f u dZZ dZZ i1 s s e
fuggita	f u dZZ dZZ i1 t a
fuggiti	f u dZZ dZZ i1 t i
fuggito	f u dZZ dZZ i1 t o
fuggiva	f u dZZ dZZ i1 v a
fuggono	f u1 g g o n o
fui	f u1 i
fulminata	f u l m i n a1 t a
fulminato	f u l m i n a1 t o
fummo	f u1 m m o
fumo	f u1 m o
fune	f u1 n e
fuochi	f w OO k i
fuoco	f w OO k o
fuori	f w OO r i
furia	f u1 r j a
furie	f u1 r j e
furiosa	f u r j o1 s a
furiosamente	f u r j o s a m e1 n t e
furiosi	f u r j o1 s i
furioso	f u r j o1 s o
furono	f u1 r o n o
furore	f u r o1 r e
furtivamente	f u r t i v a m e1 n t e
furto	f u1 r t o
fusse	f u1 s s e
futura	f u t u1 r a
future	f u t u1 r e
futuri	f u t u1 r i
futuro	f u t u1 r o
gabriello	g a b r j EE l l o
gagliarda	g a LL LL a1 r d a
gagliardo	g a LL LL a1 r d o
gaio	g a1 j o
galea	g a l EE a
galee	g a l EE e
galileo	g a l i l EE o
galle	g a1 l l e
gallica	g a1 l l i k a
galline	g a l l i1 n e
gallo	g a1 l l o
gamba	g a1 m b a
gambe	g a1 m b e
ganimede	g a n i m EE d e
gara	g a1 r a
garbo	g a1 r b o
garibaldi	g a r i b a1 l d i
garzone	g a r dz o1 n e
garzoni	g a r dz o1 n i
gastaldo	g a s t a1 l d o
geloso	dZZ e l o1 s o
gemme	dZZ EE m m e
geneologia	dZZ e n e o l o dZZ i1 a
genera	dZZ EE n e r a
generale	dZZ e n e r a1 l e
generali	dZZ e n e r a1 l i
generalmente	dZZ e n e r a l m e1 n t e
generare	dZZ e n e r a1 r e
generasse	dZZ e n e r a1 s s e
generata	dZZ e n e r a1 t a
generati	dZZ e n e r a1 t i
generato	dZZ e n e r a1 t o
generazione	dZZ e n e r a ts ts j o1 n e
genere	dZZ EE n e r e
generi	dZZ EE n e r i
genero	dZZ EE n e r o
generò	dZZ e n e r OO
generosa	dZZ e n e r o1 s a
generosi	dZZ e n e r o1 s i
generosità	dZZ e n e r o s i t a1
generoso	dZZ e n e r o1 s o
genio	dZZ EE n j o
genova	dZZ EE n o v a
genovese	dZZ e n o v e1 s e
genovesi	dZZ e n o v e1 s i
gente	dZZ EE n t e
genti	dZZ EE n t i
gentile	dZZ e n t i1 l e
gentilezza	dZZ e n t i l e1 ts ts a
gentili	dZZ e n t i1 l i
gentiluomo	dZZ e n t i l w OO m o
geometria	dZZ e o m e t r i1 a
georgica	dZZ e OO r dZZ i k a
gerbino	dZZ EE r b i n o
geri	dZZ e1 r i
g	g
ghiaccio	g j a1 tSS tSS o
ghirlanda	g i r l a1 n d a
ghirlande	g i r l a1 n d e
giace	dZZ a1 tSS e
giacere	dZZ a tSS e1 r e
giacesse	dZZ a tSS e1 s s e
giaceva	dZZ a tSS e1 v a
giacitura	dZZ a tSS i t u1 r a
giacomino	dZZ a k o m i1 n o
giacque	dZZ a1 k k w e
già	dZZ a1
gia	dZZ i1 a
giamai	dZZ a m a1 i
giammai	dZZ a m m a1 i
gianni	dZZ a1 n n i
giardini	dZZ a r d i1 n i
giardino	dZZ a r d i1 n o
giesù	dZZ e z u1
gigante	dZZ i g a1 n t e
giganti	dZZ i g a1 n t i
gilberto	dZZ i l b EE r t o
ginocchio	dZZ i n OO k k j o
giogo	dZZ o1 g o
gioia	dZZ OO j a
giornata	dZZ o r n a1 t a
giornate	dZZ o r n a1 t e
giorni	dZZ o1 r n i
giorno	dZZ o1 r n o
giova	dZZ o1 v a
giovamento	dZZ o v a m e1 n t o
giovan	dZZ o v a1 n
giovane	dZZ o1 v a n e
giovanetta	dZZ o v a n e1 t t a
giovanetto	dZZ o v a n e1 t t o
giovani	dZZ o1 v a n i
giovanili	dZZ o v a n i1 l i
giovanni	dZZ o v a1 n n i
giovano	dZZ o1 v a n o
giovare	dZZ o v a1 r e
giove	dZZ OO v e
gioventù	dZZ o v e n t u1
giovevole	dZZ o v e1 v o l e
giovine	dZZ o1 v i n e
giovinezza	dZZ o v i n e1 ts ts a
gira	dZZ i1 r a
girare	dZZ i r a1 r e
girato	dZZ i r a1 t o
giri	dZZ i1 r i
giro	dZZ i1 r o
girolamo	dZZ i r OO l a m o
gita	dZZ i1 t a
gittata	dZZ i t t a1 t a
gittate	dZZ i t t a1 t e
giudaica	dZZ u d a1 i k a
giudei	dZZ u d EE i
giudeo	dZZ u d EE o
giudica	dZZ u1 d i k a
giudicando	dZZ u d i k a1 n d o
giudicare	dZZ u d i k a1 r e
giudicata	dZZ u d i k a1 t a
giudicato	dZZ u d i k a1 t o
giudicava	dZZ u d i k a1 v a
giudice	dZZ u1 d i tSS e
giudici	dZZ u1 d i tSS i
giudico	dZZ u1 d i k o
giudizio	dZZ u d i1 ts ts j o
giù	dZZ u1
giulia	dZZ u1 l j a
giuliano	dZZ u l j a1 n o
giulio	dZZ u1 l j o
giunga	dZZ u1 ng g a
giunge	dZZ u1 n dZZ e
giungere	dZZ u1 n dZZ e r e
giunse	dZZ u1 n s e
giunsero	dZZ u1 n s e r o
giunta	dZZ u1 n t a
giunte	dZZ u1 n t e
giunti	dZZ u1 n t i
giunto	dZZ u1 n t o
giuochi	dZZ w OO k i
giuoco	dZZ w OO k o
giuramento	dZZ u r a m e1 n t o
giurando	dZZ u r a1 n d o
giurare	dZZ u r a1 r e
giuro	dZZ u1 r o
giurò	dZZ u r OO
giuseppe	dZZ u z EE p p e
giuso	dZZ u1 z o
giusta	dZZ u1 s t a
giustamente	dZZ u s t a m e1 n t e
giusti	dZZ u1 s t i
giustino	dZZ u s t i1 n o
giustizia	dZZ u s t i1 ts ts j a
giusto	dZZ u1 s t o
glauca	g l a1 u k a
glauco	g l a1 u k o
gliele	LL e1 l e
glielo	LL e1 l o
gliene	LL e1 n e
gli	LL i1
gloria	g l OO r j a
gloriosa	g l o r j o1 s a
gloriosi	g l o r j o1 s i
glorioso	g l o r j o1 s o
gode	g OO d e
godere	g o d e1 r e
gola	g o1 l a
gorgo	g o1 r g o
gostanza	g o s t a1 n ts a
governare	g o v e r n a1 r e
governatore	g o v e r n a t o1 r e
governo	g o v EE r n o
gradazione	g r a d a ts ts j o1 n e
gradi	g r a1 d i
gradimento	g r a d i m e1 n t o
grado	g r a1 d o
gramigna	g r a m i1 JJ JJ a
grande	g r a1 n d e
grandemente	g r a n d e m e1 n t e
grandezza	g r a n d e1 ts ts a
grandi	g r a1 n d i
grandissima	g r a n d i1 s s i m a
grandissime	g r a n d i1 s s i m e
grandissimi	g r a n d i1 s s i m i
grandissimo	g r a n d i1 s s i m o
grani	g r a1 n i
grano	g r a1 n o
grata	g r a1 t a
gratitudine	g r a t i t u1 d i n e
grato	g r a1 t o
gratuita	g r a t u1 i t a
grava	g r a1 v a
grave	g r a1 v e
gravemente	g r a v e m e1 n t e
gravezza	g r a v e1 ts ts a
gravida	g r a1 v i d a
gravi	g r a1 v i
gravissima	g r a v i1 s s i m a
gravissime	g r a v i1 s s i m e
gravissimo	g r a v i1 s s i m o
gravità	g r a v i t a1
gravosa	g r a v o1 s a
gravoso	g r a v o1 s o
grazia	g r a1 ts ts j a
grazie	g r a1 ts ts j e
graziosa	g r a ts ts j o1 s a
graziosamente	g r a ts ts j o s a m e1 n t e
graziose	g r a ts ts j o1 s e
graziosi	g r a ts ts j o1 s i
grazioso	g r a ts ts j o1 s o
greca	g r EE k a
greche	g r EE k e
grecia	g r EE tSS a
greci	g r EE tSS i
greco	g r EE k o
gregge	g r e1 dZZ dZZ e
greggi	g r e1 dZZ dZZ i
grembo	g r EE m b o
greve	g r EE v e
grida	g r i1 d a
gridando	g r i d a1 n d o
gridare	g r i d a1 r e
gridava	g r i d a1 v a
gridi	g r i1 d i
grido	g r i1 d o
grossa	g r OO s s a
grosse	g r OO s s e
grossezza	g r o s s e1 ts ts a
grossi	g r OO s s i
grosso	g r OO s s o
grotta	g r OO t t a
grotte	g r OO t t e
guadagnare	g w a d a JJ JJ a1 r e
guadagnata	g w a d a JJ JJ a1 t a
guadagnato	g w a d a JJ JJ a1 t o
guadagni	g w a d a1 JJ JJ i
guadagno	g w a d a1 JJ JJ o
guai	g w a1 i
gualtieri	g w a l t j e1 r i
guance	g w a1 n tSS e
guarda	g w a1 r d a
guardando	g w a r d a1 n d o
guardano	g w a1 r d a n o
guardare	g w a r d a1 r e
guardasse	g w a r d a1 s s e
guardata	g w a r d a1 t a
guardate	g w a r d a1 t e
guardati	g w a r d a1 t i
guardato	g w a r d a1 t o
guardava	g w a r d a1 v a
guardiano	g w a r d j a1 n o
guardi	g w a1 r d i
guardino	g w a1 r d i n o
guardo	g w a1 r d o
guardò	g w a r d OO
guari	g w a1 r i
guasta	g w a1 s t a
guastare	g w a s t a1 r e
guasti	g w a1 s t i
guasto	g w a1 s t o
guerra	g w EE r r a
guerre	g w EE r r e
guerriero	g w e r r j EE r o
guida	g w i1 d a
guidano	g w i1 d a n o
guidare	g w i d a1 r e
guidata	g w i d a1 t a
guidati	g w i d a1 t i
guidato	g w i d a1 t o
guidava	g w i d a1 v a
guiderdone	g w i d e r d o1 n e
guidi	g w i1 d i
guido	g w i1 d o
guisa	g w i1 z a
guise	g w i1 z e
gustare	g u s t a1 r e
gustato	g u s t a1 t o
gusto	g u1 s t o
ha	a1
hai	a1 i
hanno	a1 n n o
helena	e l EE n a
ho	o1
ida	i1 d a
iddii	i d d i1 i
iddio	i d d i1 o
idea	i d EE a
ideale	i d e a1 l e
idee	i d EE e
ideo	i d EE o
idioma	i d j OO m a
ieri	j EE r i
ignominia	i JJ JJ o m i1 n j a
ignorante	i JJ JJ o r a1 n t e
ignoranti	i JJ JJ o r a1 n t i
ignoranza	i JJ JJ o r a1 n ts a
ignorava	i JJ JJ o r a1 v a
ignoto	i JJ JJ OO t o
ignuda	i JJ JJ u1 d a
ignude	i JJ JJ u1 d e
ignudi	i JJ JJ u1 d i
ignudo	i JJ JJ u1 d o
iguale	i g w a1 l e
iguali	i g w a1 l i
i	i1
ilario	i l a1 r j o
il	i1 l
ilia	i1 l j a
illusione	i l l u z j o1 n e
illusioni	i l l u z j o1 n i
illustre	i l l u1 s t r e
illustri	i l l u1 s t r i
illustrissima	i l l u s t r i1 s s i m a
imaginando	i m a dZZ i n a1 n d o
imbarazzo	i m b a r a1 ts ts o
imitando	i m i t a1 n d o
immagini	i m m a1 dZZ i n i
immediatamente	i m m e d j a t a m e1 n t e
immobile	i m m OO b i l e
immortale	i m m o r t a1 l e
immortali	i m m o r t a1 l i
impaziente	i m p a ts ts j EE n t e
impazienza	i m p a ts ts j EE n ts a
impedimento	i m p e d i m e1 n t o
impedita	i m p e d i1 t a
impedito	i m p e d i1 t o
imperadore	i m p e r a d o1 r e
imperadori	i m p e r a d o1 r i
imperatore	i m p e r a t o1 r e
imperio	i m p EE r j o
impeto	i1 m p e t o
impetuoso	i m p e t u o1 s o
implacabile	i m p l a k a1 b i l e
importa	i m p OO r t a
impose	i m p o1 s e
impossibile	i m p o s s i1 b i l e
impossibili	i m p o s s i1 b i l i
imposte	i m p OO s t e
imposto	i m p OO s t o
impregnata	i m p r e JJ JJ a1 t a
impregnò	i m p r e JJ JJ OO
imprendere	i m p r EE n d e r e
impresa	i m p r e1 s a
imprese	i m p r e1 s e
impressione	i m p r e s s j o1 n e
improvvisamente	i m p r o v v i z a m e1 n t e
improvviso	i m p r o v v i1 z o
impulso	i m p u1 l s o
inanzi	i n a1 n ts i
incanti	i ng k a1 n t i
incapace	i ng k a p a1 tSS e
incarnazione	i ng k a r n a ts ts j o1 n e
incendia	i n tSS EE n d j a
incendio	i n tSS EE n d j o
incerta	i n tSS EE r t a
incerto	i n tSS EE r t o
inchinati	i ng k i n a1 t i
inchinato	i ng k i n a1 t o
inclito	i1 ng k l i t o
incominciai	i ng k o m i n tSS a1 i
incomincia	i ng k o m i1 n tSS a
incominciando	i ng k o m i n tSS a1 n d o
incominciano	i ng k o m i1 n tSS a n o
incominciare	i ng k o m i n tSS a1 r e
incominciarono	i ng k o m i n tSS a1 r o n o
incominciasse	i ng k o m i n tSS a1 s s e
incominciata	i ng k o m i n tSS a1 t a
incominciato	i ng k o m i n tSS a1 t o
incominciava	i ng k o m i n tSS a1 v a
incominci	i ng k o m i1 n tSS i
incominciò	i ng k o m i n tSS OO
incomparabile	i ng k o m p a r a1 b i l e
incontanente	i ng k o n t a n EE n t e
incontro	i ng k o1 n t r o
inconvenevolmente	i ng k o nf v e n e v o l m e1 n t e
incorrere	i ng k o1 r r e r e
indarno	i n d a1 r n o
indice	i n d i1 tSS e
indietro	i n d j EE t r o
indifferente	i n d i f f e r EE n t e
indi	i1 n d i
indirizzo	i n d i r i1 ts ts o
individuale	i n d i v i d u a1 l e
indizio	i n d i1 ts ts j o
indole	i1 n d o l e
indosso	i n d OO s s o
indovinare	i n d o v i n a1 r e
indovino	i n d o v i1 n o
induce	i n d u1 tSS e
indugio	i n d u1 dZZ o
industria	i n d u1 s t r j a
ineffabile	i n e f f a1 b i l e
inestimabile	i n e s t i m a1 b i l e
infallibile	i nf f a l l i1 b i l e
infame	i nf f a1 m e
infamia	i nf f a1 m j a
infatti	i nf f a1 t t i
infelice	i nf f e l i1 tSS e
infelicemente	i nf f e l i tSS e m e1 n t e
infelici	i nf f e l i1 tSS i
inferiore	i nf f e r j o1 r e
inferiori	i nf f e r j o1 r i
inferma	i nf f e1 r m a
infermi	i nf f e1 r m i
infermità	i nf f e r m i t a1
infermo	i nf f e1 r m o
infermò	i nf f e r m OO
infernale	i nf f e r n a1 l e
infernali	i nf f e r n a1 l i
inferno	i nf f EE r n o
infiammata	i nf f j a m m a1 t a
infiammati	i nf f j a m m a1 t i
infiammato	i nf f j a m m a1 t o
infima	i1 nf f i m a
infine	i nf f i1 n e
infinita	i nf f i n i1 t a
infinite	i nf f i n i1 t e
infiniti	i nf f i n i1 t i
infinito	i nf f i n i1 t o
infino	i nf f i1 n o
informato	i nf f o r m a1 t o
informazione	i nf f o r m a ts ts j o1 n e
informazioni	i nf f o r m a ts ts j o1 n i
infortunii	i nf f o r t u1 n j i
infortunio	i nf f o r t u1 n j o
ingannare	i ng g a n n a1 r e
ingannata	i ng g a n n a1 t a
ingannati	i ng g a n n a1 t i
ingannato	i ng g a n n a1 t o
inganni	i ng g a1 n n i
inganno	i ng g a1 n n o
ingegnati	i n dZZ e JJ JJ a1 t i
ingegnato	i n dZZ e JJ JJ a1 t o
ingegni	i n dZZ e1 JJ JJ i
ingegno	i n dZZ e1 JJ JJ o
inghilterra	i ng g i l t EE r r a
inghiottita	i ng g j o t t i1 t a
ingiuria	i n dZZ u1 r j a
ingiurie	i n dZZ u1 r j e
ingiusta	i n dZZ u1 s t a
ingiustamente	i n dZZ u s t a m e1 n t e
ingiusto	i n dZZ u1 s t o
ingordigia	i ng g o r d i1 dZZ a
ingrata	i ng g r a1 t a
in	i1 n
inimica	i n i m i1 k a
inimici	i n i m i1 tSS i
inimico	i n i m i1 k o
iniqua	i n i1 k w a
inique	i n i1 k w e
iniqui	i n i1 k w i
iniquità	i n i k w i t a1
iniquo	i n i1 k w o
iniziale	i n i ts ts j a1 l e
iniziativa	i n i ts ts j a t i1 v a
innamoramento	i n n a m o r a m e1 n t o
innamorare	i n n a m o r a1 r e
innamorata	i n n a m o r a1 t a
innamorate	i n n a m o r a1 t e
innamorati	i n n a m o r a1 t i
innamorato	i n n a m o r a1 t o
innanzi	i n n a1 n ts i
innocente	i n n o tSS EE n t e
innocenti	i n n o tSS EE n t i
inquisitore	i ng k w i z i t o1 r e
insegna	i n s e1 JJ JJ a
insegnare	i n s e JJ JJ a1 r e
insegnato	i n s e JJ JJ a1 t o
insegne	i n s e1 JJ JJ e
insegnò	i n s e JJ JJ OO
insensibili	i n s e n s i1 b i l i
insidie	i n s i1 d j e
insieme	i n s j EE m e
insiememente	i n s j e m e m e1 n t e
insino	i n s i1 n o
insistente	i n s i s t EE n t e
insomma	i n s o1 m m a
intanto	i n t a1 n t o
intelletto	i n t e l l EE t t o
intelligenza	i n t e l l i dZZ EE n ts a
intenda	i n t EE n d a
intende	i n t EE n d e
intendendo	i n t e n d EE n d o
intendente	i n t e n d EE n t e
intendere	i n t EE n d e r e
intendeva	i n t e n d e1 v a
intendiamo	i n t e n d j a1 m o
intendi	i n t EE n d i
intendimento	i n t e n d i m e1 n t o
intendo	i n t EE n d o
intendono	i n t EE n d o n o
intensa	i n t EE n s a
intensamente	i n t e n s a m e1 n t e
intenti	i n t EE n t i
intento	i n t EE n t o
intenzione	i n t e n ts j o1 n e
intera	i n t e1 r a
interamente	i n t e r a m e1 n t e
intere	i n t e1 r e
interesse	i n t e r EE s s e
interessi	i n t e r EE s s i
inter	i1 n t e r
interi	i n t e1 r i
interiora	i n t e r j o1 r a
intero	i n t e1 r o
interpretata	i n t e r p r e t a1 t a
interpretato	i n t e r p r e t a1 t o
interprete	i n t EE r p r e t e
interpreti	i n t EE r p r e t i
interrotto	i n t e r r o1 t t o
intervenire	i n t e r v e n i1 r e
intervenuto	i n t e r v e n u1 t o
intesa	i n t e1 s a
intese	i n t e1 s e
intesi	i n t e1 s i
inteso	i n t e1 s o
intiero	i n t j EE r o
intima	i n t i1 m a
intitolò	i n t i t o l OO
intollerabile	i n t o l l e r a1 b i l e
intorno	i n t o1 r n o
introduce	i n t r o d u1 tSS e
introduzione	i n t r o d u ts ts j o1 n e
inutile	i n u1 t i l e
invano	i nf v a1 n o
invece	i nf v e1 tSS e
inventore	i nf v e n t o1 r e
inventori	i nf v e n t o1 r i
inverso	i nf v EE r s o
investigazione	i nf v e s t i g a ts ts j o1 n e
invia	i nf v i1 a
invidia	i nf v i1 d j a
invidiosa	i nf v i d j o1 s a
invidiosi	i nf v i d j o1 s i
invidioso	i nf v i d j o1 s o
invitati	i nf v i t a1 t i
invitato	i nf v i t a1 t o
involto	i nf v OO l t o
io	i1 o
iole	j OO l e
ione	j o1 n e
ionio	j OO n j o
ira	i1 r a
ire	i1 r e
iris	i1 r i s
ischia	i1 s k j a
iside	i1 z i d e
isidoro	i z i d OO r o
isola	i1 z o l a
isole	i1 z o l e
istante	i s t a1 n t e
istessa	i s t e1 s s a
istesse	i s t e1 s s e
istesso	i s t e1 s s o
istoria	i s t OO r j a
ita	i1 t a
italia	i t a1 l j a
italiana	i t a l j a1 n a
italiani	i t a l j a1 n i
italiano	i t a l j a1 n o
ito	i1 t o
ivi	i1 v i
labbra	l a1 b b r a
labbro	l a1 b b r o
laccio	l a1 tSS tSS o
lacedemone	l a tSS e d EE m o n e
lacedemoni	l a tSS e d EE m o n i
lacerato	l a tSS e r a1 t o
ladri	l a1 d r i
ladro	l a1 d r o
ladrone	l a d r o1 n e
ladroni	l a d r o1 n i
laggiù	l a dZZ dZZ u1
laghi	l a1 g i
lago	l a1 g o
lagrima	l a1 g r i m a
lagrime	l a1 g r i m e
la	l a1
là	l a1
lamenti	l a m e1 n t i
lamento	l a m e1 n t o
lampada	l a1 m p a d a
lampo	l a1 m p o
lana	l a1 n a
lance	l a1 n tSS e
lancia	l a1 n tSS a
lanterna	l a n t EE r n a
larga	l a1 r g a
largamente	l a r g a m e1 n t e
larghe	l a1 r g e
largo	l a1 r g o
lasciai	l a SS SS a1 i
lascia	l a1 SS SS a
lasciamo	l a SS SS a1 m o
lasciando	l a SS SS a1 n d o
lasciano	l a1 SS SS a n o
lasciare	l a SS SS a1 r e
lasciarono	l a SS SS a1 r o n o
lasciasse	l a SS SS a1 s s e
lasciassero	l a SS SS a1 s s e r o
lasciasti	l a SS SS a1 s t i
lasciata	l a SS SS a1 t a
lasciate	l a SS SS a1 t e
lasciati	l a SS SS a1 t i
lasciato	l a SS SS a1 t o
lasciava	l a SS SS a1 v a
lasciavano	l a SS SS a1 v a n o
lascierò	l a SS SS e r OO
lasci	l a1 SS SS i
lascino	l a1 SS SS i n o
lascio	l a1 SS SS o
lasciò	l a SS SS OO
lascivia	l a SS SS i1 v j a
lascivie	l a SS SS i1 v j e
lascivi	l a SS SS i1 v i
lascivo	l a SS SS i1 v o
lassi	l a1 s s i
lasso	l a1 s s o
lassù	l a s s u1
lati	l a1 t i
latina	l a t i1 n a
latinamente	l a t i n a m e1 n t e
latine	l a t i1 n e
latini	l a t i1 n i
latino	l a t i1 n o
lato	l a1 t o
latrare	l a t r a1 r e
latte	l a1 t t e
laude	l a1 u d e
laura	l a1 u r a
laurea	l a1 u r e a
laurenti	l a u r EE n t i
lauretta	l a u r e1 t t a
lauro	l a1 u r o
lavacro	l a v a1 k r o
lavare	l a v a1 r e
lavato	l a v a1 t o
lavinia	l a v i1 n j a
lavorare	l a v o r a1 r e
lavoratore	l a v o r a t o1 r e
lavoratori	l a v o r a t o1 r i
lavorava	l a v o r a1 v a
lavorio	l a v o r i1 o
lavoro	l a v o1 r o
lazzaretto	l a dz dz a r e1 t t o
leale	l e a1 l e
lealmente	l e a l m e1 n t e
lealtà	l e a l t a1
leandro	l e a1 n d r o
learco	l e a1 r k o
lecito	l e1 tSS i t o
leda	l EE d a
lega	l e1 g a
legame	l e g a1 m e
legami	l e g a1 m i
legare	l e g a1 r e
legarono	l e g a1 r o n o
legata	l e g a1 t a
legate	l e g a1 t e
legati	l e g a1 t i
legato	l e g a1 t o
legga	l EE g g a
leggano	l EE g g a n o
legge	l EE dZZ dZZ e
leggendo	l e dZZ dZZ EE n d o
leggeranno	l e dZZ dZZ e r a1 n n o
leggere	l EE dZZ dZZ e r e
leggiadra	l e dZZ dZZ a1 d r a
leggiadramente	l e dZZ dZZ a d r a m e1 n t e
leggiadre	l e dZZ dZZ a1 d r e
leggiadria	l e dZZ dZZ a d r i1 a
leggiadri	l e dZZ dZZ a1 d r i
leggiadro	l e dZZ dZZ a1 d r o
leggiamo	l e dZZ dZZ a1 m o
leggiera	l e dZZ dZZ EE r a
leggiere	l e dZZ dZZ EE r e
leggieri	l e dZZ dZZ EE r i
leggiero	l e dZZ dZZ EE r o
leggi	l EE dZZ dZZ i
leggono	l EE g g o n o
legittima	l e dZZ i1 t t i m a
legne	l e1 JJ JJ e
legni	l e1 JJ JJ i
legno	l e1 JJ JJ o
legò	l e g OO
lei	l EE i
le	l e
lelio	l EE l j o
lena	l e1 n a
lentamente	l e n t a m e1 n t e
lente	l EE n t e
lenti	l EE n t i
lento	l EE n t o
leonardo	l e o n a1 r d o
leone	l e o1 n e
leoni	l e o1 n i
letizia	l e t i1 ts ts j a
lette	l EE t t e
lettera	l EE t t e r a
letterarie	l e t t e r a1 r j e
lettere	l EE t t e r e
letti	l EE t t i
letto	l EE t t o
lettore	l e t t o1 r e
lettori	l e t t o1 r i
lettura	l e t t u1 r a
levai	l e v a1 i
leva	l EE v a
levando	l e v a1 n d o
levano	l EE v a n o
levare	l e v a1 r e
levarono	l e v a1 r o n o
levasse	l e v a1 s s e
levata	l e v a1 t a
levate	l e v a1 t e
levati	l e v a1 t i
levato	l e v a1 t o
levava	l e v a1 v a
levi	l EE v i
levò	l e v OO
lezzo	l e1 dz dz o
liberale	l i b e r a1 l e
libera	l i1 b e r a
liberali	l i b e r a1 l i
liberalità	l i b e r a l i t a1
liberare	l i b e r a1 r e
liberata	l i b e r a1 t a
liberato	l i b e r a1 t o
liberazione	l i b e r a ts ts j o1 n e
libere	l i1 b e r e
liberi	l i1 b e r i
liber	l i1 b e r
libero	l i1 b e r o
liberò	l i b e r OO
libertà	l i b e r t a1
libia	l i1 b j a
libidine	l i b i1 d i n e
libidinoso	l i b i d i n o1 s o
libretto	l i b r e1 t t o
libri	l i1 b r i
libro	l i1 b r o
licaone	l i k a o1 n e
licenza	l i tSS EE n ts a
licenze	l i tSS EE n ts e
licenzia	l i tSS EE n ts j a
licenziò	l i tSS e n ts j OO
licenziosamente	l i tSS e n ts j o s a m e1 n t e
liceo	l i tSS EE o
licia	l i1 tSS a
licito	l i1 tSS i t o
lidia	l i1 d j a
lido	l i1 d o
lieta	l j EE t a
lietamente	l j e t a m e1 n t e
liete	l j EE t e
lieti	l j EE t i
lietissimo	l j e t i1 s s i m o
lieto	l j EE t o
lieve	l j EE v e
lievi	l j EE v i
li	l i1
lì	l i1
limite	l i1 m i t e
limosina	l i m o z i1 n a
limosine	l i m o z i1 n e
linceo	l i n tSS EE o
linea	l i1 n e a
lineamenti	l i n e a m e1 n t i
linee	l i1 n e e
linguaggio	l i ng g w a1 dZZ dZZ o
lingua	l i1 ng g w a
lingue	l i1 ng g w e
lino	l i1 n o
lipari	l i1 p a r i
liquori	l i k w o1 r i
lira	l i1 r a
lisa	l i1 z a
lisetta	l i z e1 t t a
lite	l i1 t e
litigio	l i t i1 dZZ o
liti	l i1 t i
livio	l i1 v j o
l	l
locati	l o k a1 t i
locato	l o k a1 t o
lochi	l OO k i
loco	l OO k o
loda	l OO d a
lodando	l o d a1 n d o
lodare	l o d a1 r e
lodata	l o d a1 t a
lodati	l o d a1 t i
lodato	l o d a1 t o
lode	l OO d e
lodevole	l o d e1 v o l e
lodevoli	l o d e1 v o l i
lodi	l OO d i
lodovico	l o d o v i1 k o
logica	l OO dZZ i k a
lo	l o1
lombardia	l o m b a r d i1 a
londra	l o1 n d r a
lontana	l o n t a1 n a
lontananza	l o n t a n a1 n ts a
lontane	l o n t a1 n e
lontani	l o n t a1 n i
lontano	l o n t a1 n o
lorenzo	l o r EE n ts o
loreta	l o r e1 t a
loro	l o1 r o
lotta	l OO t t a
lucano	l u k a1 n o
luce	l u1 tSS e
lucente	l u tSS EE n t e
lucenti	l u tSS EE n t i
lucifero	l u tSS i1 f e r o
luci	l u1 tSS i
lucina	l u tSS i1 n a
lucio	l u1 tSS o
luglio	l u1 LL LL o
luigi	l w i1 dZZ i
lui	l u1 i
lume	l u1 m e
lumi	l u1 m i
luna	l u1 n a
lunga	l u1 ng g a
lungamente	l u ng g a m e1 n t e
lunge	l u1 n dZZ e
lunghe	l u1 ng g e
lunghezza	l u ng g e1 ts ts a
lunghi	l u1 ng g i
lunghissima	l u ng g i1 s s i m a
lunghissimi	l u ng g i1 s s i m i
lungi	l u1 n dZZ i
lungo	l u1 ng g o
luoghi	l w OO g i
luogo	l w OO g o
lupi	l u1 p i
lupo	l u1 p o
lusca	l u1 s k a
lusinghe	l u z i1 ng g e
lussuria	l u s s u1 r j a
macchia	m a1 k k j a
macchiare	m a k k j a1 r e
macchiata	m a k k j a1 t a
macchiati	m a k k j a1 t i
macchie	m a1 k k j e
machiavelli	m a k j a v EE l l i
madama	m a d a1 m a
maddalena	m a d d a l EE n a
madonna	m a d OO n n a
madre	m a1 d r e
madri	m a1 d r i
maestà	m a e s t a1
maestra	m a EE s t r a
maestri	m a EE s t r i
maestro	m a EE s t r o
maggio	m a1 dZZ dZZ o
maggioranza	m a dZZ dZZ o r a1 n ts a
maggiore	m a dZZ dZZ o1 r e
maggiori	m a dZZ dZZ o1 r i
maggiormente	m a dZZ dZZ o r m e1 n t e
magna	m a1 JJ JJ a
magnanimità	m a JJ JJ a n i m i t a1
magnanimo	m a JJ JJ a1 n i m o
magnifica	m a JJ JJ i1 f i k a
magnificamente	m a JJ JJ i f i k a m e1 n t e
magnificenza	m a JJ JJ i f i tSS EE n ts a
magnifiche	m a JJ JJ i1 f i k e
magnifico	m a JJ JJ i1 f i k o
magno	m a1 JJ JJ o
magro	m a1 g r o
maia	m a1 j a
mai	m a1 i
malagevole	m a l a dZZ e1 v o l e
malagevolmente	m a l a dZZ e v o l m e1 n t e
mala	m a1 l a
malamente	m a l a m e1 n t e
male	m a1 l e
malgrado	m a l g r a1 d o
maligna	m a l i1 JJ JJ a
maligni	m a l i1 JJ JJ i
malignità	m a l i JJ JJ i t a1
mali	m a1 l i
malinconia	m a l i ng k o n i1 a
malinconico	m a l i ng k OO n i k o
malizia	m a l i1 ts ts j a
malvagia	m a l v a1 dZZ a
malvagi	m a l v a1 dZZ i
malvagio	m a l v a1 dZZ o
malvagità	m a l v a dZZ i t a1
ma	m a1
mamma	m a1 m m a
manca	m a1 ng k a
mancamento	m a ng k a m e1 n t o
mancando	m a ng k a1 n d o
mancano	m a1 ng k a n o
mancante	m a ng k a1 n t e
mancanza	m a ng k a1 n ts a
mancare	m a ng k a1 r e
mancarono	m a ng k a1 r o n o
mancasse	m a ng k a1 s s e
mancato	m a ng k a1 t o
mancava	m a ng k a1 v a
manchi	m a1 ng k i
manco	m a1 ng k o
mancò	m a ng k OO
manda	m a1 n d a
mandando	m a n d a1 n d o
mandano	m a1 n d a n o
mandare	m a n d a1 r e
mandar	m a n d a1 r
mandarono	m a n d a1 r o n o
mandasse	m a n d a1 s s e
mandata	m a n d a1 t a
mandate	m a n d a1 t e
mandati	m a n d a1 t i
mandato	m a n d a1 t o
mandava	m a n d a1 v a
manderò	m a n d e r OO
mandi	m a1 n d i
mando	m a1 n d o
mandò	m a n d OO
manfredi	m a nf f r e1 d i
mangia	m a1 n dZZ a
mangiando	m a n dZZ a1 n d o
mangiare	m a n dZZ a1 r e
mangiato	m a n dZZ a1 t o
mangiava	m a n dZZ a1 v a
mangiò	m a n dZZ OO
maniera	m a n j EE r a
maniere	m a n j EE r e
manifesta	m a n i f EE s t a
manifestamente	m a n i f e s t a m e1 n t e
manifestare	m a n i f e s t a1 r e
manifesti	m a n i f EE s t i
manifesto	m a n i f EE s t o
manifestò	m a n i f e s t OO
mani	m a1 n i
mano	m a1 n o
mansuetudine	m a n s u e t u1 d i n e
mantello	m a n t EE l l o
mantenne	m a n t e1 n n e
manto	m a1 n t o
mantova	m a1 n t o v a
mantovano	m a n t o v a1 n o
maraviglia	m a r a v i1 LL LL a
maraviglie	m a r a v i1 LL LL e
marchese	m a r k e1 z e
marco	m a1 r k o
mare	m a1 r e
maria	m a r i1 a
marica	m a1 r i k a
mari	m a1 r i
marina	m a r i1 n a
marinari	m a r i n a1 r i
marine	m a r i1 n e
marini	m a r i1 n i
marino	m a r i1 n o
maritata	m a r i t a1 t a
mariti	m a r i1 t i
marito	m a r i1 t o
maritò	m a r i t OO
marmi	m a1 r m i
marmo	m a1 r m o
marmorina	m a r m o r i1 n a
martellino	m a r t e l l i1 n o
marte	m a1 r t e
martiri	m a r t i1 r i
marx	m a1 r k s
marzo	m a1 r ts o
maschi	m a1 s k i
maschio	m a1 s k j o
masnadieri	m a z n a d j EE r i
maso	m a1 z o
massa	m a1 s s a
massimamente	m a s s i m a m e1 n t e
massime	m a1 s s i m e
massimo	m a1 s s i m o
materiale	m a t e r j a1 l e
materia	m a t EE r j a
materie	m a t EE r j e
matrimoniale	m a t r i m o n j a1 l e
matrimoni	m a t r i m OO n i
matrimonio	m a t r i m OO n j o
matta	m a1 t t a
mattia	m a t t i1 a
mattina	m a t t i1 n a
matto	m a1 t t o
matura	m a t u1 r a
maturi	m a t u1 r i
mauritania	m a u r i t a1 n j a
mazziniano	m a ts ts i n j a1 n o
mazzini	m a ts ts i1 n i
mazzo	m a1 ts ts o
meco	m e1 k o
medesima	m e d e1 z i m a
medesimamente	m e d e z i m a m e1 n t e
medesime	m e d e1 z i m e
medesimi	m e d e1 z i m i
medesimo	m e d e1 z i m o
media	m EE d j a
mediante	m e d j a1 n t e
medicare	m e d i k a1 r e
medici	m EE d i tSS i
medicina	m e d i tSS i1 n a
medicine	m e d i tSS i1 n e
medico	m EE d i k o
medioevo	m e d j o EE v o
medusa	m e d u1 z a
megera	m e dZZ EE r a
meglio	m EE LL LL o
mei	m EE i
mela	m e1 l a
melano	m e1 l a n o
mele	m e1 l e
melodia	m e l o d i1 a
membra	m EE m b r a
membri	m EE m b r i
membro	m EE m b r o
me	m e1
memorabile	m e m o r a1 b i l e
memoria	m e m OO r j a
memorie	m e m OO r j e
mena	m e1 n a
menando	m e n a1 n d o
menare	m e n a1 r e
menarono	m e n a1 r o n o
menasse	m e n a1 s s e
menata	m e n a1 t a
menati	m e n a1 t i
menato	m e n a1 t o
menava	m e n a1 v a
meni	m e1 n i
menoma	m EE n o m a
meno	m e1 n o
menò	m e n OO
mensa	m EE n s a
mense	m EE n s e
mente	m e1 n t e
menti	m e1 n t i
mentire	m e n t i1 r e
mento	m e1 n t o
mentre	m e1 n t r e
menzione	m e n ts j o1 n e
menzogna	m e n ts o1 JJ JJ a
menzogne	m e n ts o1 JJ JJ e
meraviglia	m e r a v i1 LL LL a
mercante	m e r k a1 n t e
mercanti	m e r k a1 n t i
mercatante	m e r k a t a1 n t e
mercatanti	m e r k a t a1 n t i
mercato	m e r k a1 t o
mercede	m e r tSS e1 d e
mercé	m e r tSS e1
mercurio	m e r k u1 r j o
meretrice	m e r e t r i1 tSS e
meretrici	m e r e t r i1 tSS i
meridiano	m e r i d j a1 n o
meritai	m e r i t a1 i
merita	m EE r i t a
meritamente	m e r i t a m e1 n t e
meritano	m EE r i t a n o
meritarono	m e r i t a1 r o n o
meritasse	m e r i t a1 s s e
meritata	m e r i t a1 t a
meritato	m e r i t a1 t o
meritevolmente	m e r i t e v o l m e1 n t e
meriti	m EE r i t i
merito	m EE r i t o
meritò	m e r i t OO
mescola	m e1 s k o l a
mescolata	m e s k o l a1 t a
mescolate	m e s k o l a1 t e
mescolati	m e s k o l a1 t i
mescolato	m e s k o l a1 t o
mese	m e1 s e
mesi	m e1 s i
messa	m e1 s s a
messe	m EE s s e
messere	m e s s EE r e
messi	m EE s s i
messina	m e s s i1 n a
messo	m e1 s s o
mestiere	m e s t j EE r e
mestizia	m e s t i1 ts ts j a
mesto	m EE s t o
metalli	m e t a1 l l i
metodo	m EE t o d o
metta	m e1 t t a
mette	m e1 t t e
mettendo	m e t t EE n d o
metterà	m e t t e r a1
mettere	m e1 t t e r e
mettesse	m e t t e1 s s e
metteva	m e t t e1 v a
metti	m e1 t t i
metto	m e1 t t o
mettono	m e1 t t o n o
mezzano	m e dz dz a1 n o
mezzi	m EE dz dz i
mezzogiorno	m e dz dz o dZZ o1 r n o
mezzo	m EE dz dz o
mia	m i1 a
mica	m i1 k a
michele	m i k e1 l e
miei	m j EE i
mie	m i1 e
migliaia	m i LL LL a1 j a
miglia	m i1 LL LL a
miglio	m i1 LL LL o
migliore	m i LL LL o1 r e
migliori	m i LL LL o1 r i
miglior	m i LL LL o1 r
mila	m i1 l a
milano	m i l a1 n o
militare	m i l i t a1 r e
mille	m i1 l l e
mi	m i1
minacce	m i n a1 tSS tSS e
minaccia	m i n a1 tSS tSS a
minacciando	m i n a tSS tSS a1 n d o
ministri	m i n i1 s t r i
minore	m i n o1 r e
minori	m i n o1 r i
minutamente	m i n u t a m e1 n t e
minuta	m i n u1 t a
minute	m i n u1 t e
minuti	m i n u1 t i
minuto	m i n u1 t o
mio	m i1 o
mirabile	m i r a1 b i l e
mirabili	m i r a1 b i l i
mirabilmente	m i r a b i l m e1 n t e
miracoli	m i r a1 k o l i
miracolo	m i r a1 k o l o
mira	m i1 r a
mirando	m i r a1 n d o
mirare	m i r a1 r e
miri	m i1 r i
mirmidoni	m i r m i d o1 n i
mirra	m i1 r r a
mirto	m i1 r t o
mise	m i1 z e
miserabile	m i z e r a1 b i l e
miseramente	m i z e r a m e1 n t e
misera	m i1 z e r a
misere	m i1 z e r e
miseria	m i z EE r j a
misericordia	m i z e r i k OO r d j a
miserie	m i z EE r j e
miseri	m i1 z e r i
misero	m i1 z e r o
missione	m i s s j o1 n e
misteri	m i s t EE r i
mistero	m i s t EE r o
mistieri	m i s t j EE r i
misura	m i z u1 r a
mitigare	m i t i g a1 r e
m	m
mobile	m OO b i l e
mobili	m OO b i l i
moderatamente	m o d e r a t a m e1 n t e
moderata	m o d e r a1 t a
moderati	m o d e r a1 t i
moderna	m o d EE r n a
moderni	m o d EE r n i
modesto	m o d EE s t o
modi	m OO d i
modo	m OO d o
moglie	m o1 LL LL e
mogliere	m o LL LL EE r e
mogli	m o1 LL LL i
molestia	m o l EE s t j a
molesto	m o l EE s t o
molle	m OO l l e
molli	m OO l l i
molta	m o1 l t a
molte	m o1 l t e
molti	m o1 l t i
moltitudine	m o l t i t u1 d i n e
molto	m o1 l t o
momenti	m o m e1 n t i
momento	m o m e1 n t o
monaca	m OO n a k a
monache	m OO n a k e
monaco	m OO n a k o
monarchia	m o n a r k i1 a
mondana	m o n d a1 n a
mondane	m o n d a1 n e
mondani	m o n d a1 n i
mondano	m o n d a1 n o
mondo	m o1 n d o
moneta	m o n e1 t a
monile	m o n i1 l e
monsignore	m o n s i JJ JJ o1 r e
montagna	m o n t a1 JJ JJ a
montagne	m o n t a1 JJ JJ e
monta	m o1 n t a
montare	m o n t a1 r e
montarono	m o n t a1 r o n o
montati	m o n t a1 t i
montato	m o n t a1 t o
monte	m o1 n t e
monti	m o1 n t i
montò	m o n t OO
morale	m o r a1 l e
morbide	m OO r b i d e
morbo	m OO r b o
morde	m OO r d e
mordere	m OO r d e r e
morendo	m o r EE n d o
morganti	m o r g a1 n t i
morì	m o r i1
morire	m o r i1 r e
morirono	m o r i1 r o n o
morisse	m o r i1 s s e
morissi	m o r i1 s s i
moriva	m o r i1 v a
morivano	m o r i1 v a n o
mormorare	m o r m o r a1 r e
mormorio	m o r m o r i1 o
mormorò	m o r m o r OO
morsi	m OO r s i
morso	m OO r s o
mortaio	m o r t a1 j o
mortale	m o r t a1 l e
mortali	m o r t a1 l i
mortalità	m o r t a l i t a1
mortal	m o r t a1 l
morta	m OO r t a
morte	m OO r t e
morti	m OO r t i
morto	m OO r t o
mosè	m o z EE
mossa	m OO s s a
mosse	m OO s s e
mossero	m OO s s e r o
mossi	m OO s s i
mosso	m OO s s o
mostra	m o1 s t r a
mostrando	m o s t r a1 n d o
mostrano	m o1 s t r a n o
mostrare	m o s t r a1 r e
mostrarono	m o s t r a1 r o n o
mostrasse	m o s t r a1 s s e
mostrata	m o s t r a1 t a
mostrate	m o s t r a1 t e
mostrati	m o s t r a1 t i
mostrato	m o s t r a1 t o
mostrava	m o s t r a1 v a
mostravano	m o s t r a1 v a n o
mostrerà	m o s t r e r a1
mostrerò	m o s t r e r OO
mostri	m o1 s t r i
mostro	m o1 s t r o
mostrò	m o s t r OO
moti	m OO t i
motivo	m o t i1 v o
moto	m OO t o
motteggiando	m o t t e dZZ dZZ a1 n d o
motteggiare	m o t t e dZZ dZZ a1 r e
motti	m OO t t i
motto	m OO t t o
move	m OO v e
movendo	m o v EE n d o
movesse	m o v e1 s s e
moveva	m o v e1 v a
movimenti	m o v i m e1 n t i
movimento	m o v i m e1 n t o
multa	m u1 l t a
municipio	m u n i tSS i1 p j o
muova	m w OO v a
muove	m w OO v e
muovere	m w OO v e r e
muovono	m w OO v o n o
mura	m u1 r a
muri	m u1 r i
muro	m u1 r o
museo	m u z EE o
musica	m u1 z i k a
mutamenti	m u t a m e1 n t i
mutamento	m u t a m e1 n t o
muta	m u1 t a
mutano	m u1 t a n o
mutare	m u t a1 r e
mutasse	m u t a1 s s e
mutata	m u t a1 t a
mutato	m u t a1 t o
muti	m u1 t i
mutolo	m u1 t o l o
mutò	m u t OO
nacque	n a1 k k w e
nacquero	n a1 k k w e r o
nacqui	n a1 k k w i
napoli	n a1 p o l i
narciso	n a r tSS i1 z o
nardin	n a r d i1 n
narra	n a1 r r a
narrando	n a r r a1 n d o
narrano	n a1 r r a n o
narrare	n a r r a1 r e
narrata	n a r r a1 t a
narrate	n a r r a1 t e
narrato	n a r r a1 t o
narrava	n a r r a1 v a
narrerò	n a r r e r OO
narrò	n a r r OO
nasca	n a1 s k a
nascano	n a1 s k a n o
nasce	n a1 SS SS e
nascendo	n a SS SS EE n d o
nascere	n a1 SS SS e r e
nascesse	n a SS SS e1 s s e
nascessero	n a SS SS e1 s s e r o
nasceva	n a SS SS e1 v a
nascevano	n a SS SS e1 v a n o
nasconda	n a s k o1 n d a
nasconde	n a s k o1 n d e
nascondere	n a s k o1 n d e r e
nascono	n a1 s k o n o
nascosa	n a s k o1 s a
nascose	n a s k o1 s e
nascosi	n a s k o1 s i
nascoso	n a s k o1 s o
nascosta	n a s k o1 s t a
nascoste	n a s k o1 s t e
nascosti	n a s k o1 s t i
nascosto	n a s k o1 s t o
naso	n a1 s o
natale	n a t a1 l e
nata	n a1 t a
nate	n a1 t e
nati	n a1 t i
natività	n a t i v i t a1
nato	n a1 t o
naturale	n a t u r a1 l e
naturali	n a t u r a1 l i
naturalmente	n a t u r a l m e1 n t e
natura	n a t u1 r a
nature	n a t u1 r e
naufragio	n a u f r a1 dZZ o
nave	n a1 v e
navicella	n a v i tSS EE l l a
navi	n a1 v i
nazionale	n a ts ts j o n a1 l e
nazione	n a ts ts j o1 n e
nazioni	n a ts ts j o1 n i
necessariamente	n e tSS e s s a r j a m e1 n t e
necessaria	n e tSS e s s a1 r j a
necessarie	n e tSS e s s a1 r j e
necessario	n e tSS e s s a1 r j o
necessità	n e tSS e s s i t a1
negano	n e1 g a n o
negare	n e g a1 r e
negata	n e g a1 t a
negato	n e g a1 t o
negherò	n e g e r OO
negli	n e1 LL LL i
nego	n e1 g o
negro	n e1 g r o
nei	n EE i
nella	n EE l l a
nelle	n e1 l l e
nelli	n e1 l l i
nello	n EE l l o
nel	n e1 l
nemica	n e m i1 k a
nemici	n e m i1 tSS i
nemico	n e m i1 k o
ne	n e
né	n e1
neoguelfa	n e o g w EE l f a
neoguelfo	n e o g w EE l f o
neppure	n e p p u1 r e
nequizia	n e k w i1 ts ts j a
nera	n e1 r a
nere	n e1 r e
nereo	n e1 r e o
neri	n e1 r i
nero	n e1 r o
nervi	n EE r v i
nesso	n EE s s o
nessuna	n e s s u1 n a
nessuno	n e s s u1 n o
nestore	n EE s t o r e
netto	n e1 t t o
nettuno	n e t t u1 n o
neve	n e1 v e
nevi	n e1 v i
nido	n i1 d o
niente	n j EE n t e
nilo	n i1 l o
nimica	n i m i1 k a
nimici	n i m i1 tSS i
nimico	n i m i1 k o
ninfa	n i1 nf f a
ninfe	n i1 nf f e
nipote	n i p o1 t e
nisi	n i1 z i
niuna	n j u1 n a
niuno	n j u1 n o
n	n
nobile	n OO b i l e
nobili	n OO b i l i
nobilissima	n o b i l i1 s s i m a
nobilissime	n o b i l i1 s s i m e
nobilissimi	n o b i l i1 s s i m i
nobilissimo	n o b i l i1 s s i m o
nobilmente	n o b i l m e1 n t e
nobiltà	n o b i l t a1
nocchieri	n o k k j EE r i
nocchiero	n o k k j EE r o
nocenti	n o tSS EE n t i
nodo	n OO d o
noia	n OO j a
noie	n OO j e
noi	n o1 i
noiosa	n o j o1 s a
noiose	n o j o1 s e
noiosi	n o j o1 s i
noioso	n o j o1 s o
noma	n OO m a
nomata	n o m a1 t a
nomati	n o m a1 t i
nomato	n o m a1 t o
nome	n o1 m e
nominare	n o m i n a1 r e
nominata	n o m i n a1 t a
nominato	n o m i n a1 t o
nomi	n OO m i
nomò	n o m OO
nona	n OO n a
nondimeno	n o n d i m e1 n o
nonna	n OO n n a
non	n OO n
nono	n OO n o
nostra	n OO s t r a
nostre	n OO s t r e
nostri	n OO s t r i
nostro	n OO s t r o
notabile	n o t a1 b i l e
notabili	n o t a1 b i l i
nota	n OO t a
notare	n o t a1 r e
note	n OO t e
notizia	n o t i1 ts ts j a
noto	n OO t o
notte	n OO t t e
notti	n OO t t i
notturni	n o t t u1 r n i
nova	n OO v a
novellamente	n o v e l l a m e1 n t e
novella	n o v EE l l a
novelle	n o v EE l l e
novelli	n o v EE l l i
novello	n o v EE l l o
nove	n OO v e
novità	n o v i t a1
novo	n OO v o
nozze	n OO ts ts e
nube	n u1 b e
nubi	n u1 b i
nulla	n u1 l l a
nullo	n u1 l l o
numeri	n u1 m e r i
numero	n u1 m e r o
numerosi	n u m e r o1 s i
nuoce	n w OO tSS e
nuocere	n w OO tSS e r e
nuovamente	n w o v a m e1 n t e
nuova	n w OO v a
nuove	n w OO v e
nuovi	n w OO v i
nuovo	n w OO v o
nutrice	n u t r i1 tSS e
nuvola	n u1 v o l a
nuvoli	n u1 v o l i
obbedendo	o b b e d EE n d o
obbietti	o b b j EE t t i
obbietto	o b b j EE t t o
oblio	o b l i1 o
occasione	o k k a z j o1 n e
occhi	OO k k i
occhio	OO k k j o
occidentale	o tSS tSS i d e n t a1 l e
occidentali	o tSS tSS i d e n t a1 l i
occidente	o tSS tSS i d EE n t e
occorre	o k k o1 r r e
occorse	o k k o1 r s e
occultamente	o k k u l t a m e1 n t e
occulta	o k k u1 l t a
occulte	o k k u1 l t e
occulti	o k k u1 l t i
occulto	o k k u1 l t o
occupa	OO k k u p a
occupare	o k k u p a1 r e
occupata	o k k u p a1 t a
occupati	o k k u p a1 t i
occupato	o k k u p a1 t o
occupò	o k k u p OO
oceano	o tSS EE a n o
oda	OO d a
ode	OO d e
odi	OO d i
odio	OO d j o
od	o1 d
odo	OO d o
odore	o d o1 r e
offendere	o f f EE n d e r e
offerse	o f f EE r s e
offerto	o f f EE r t o
offesa	o f f e1 s a
offese	o f f e1 s e
offesi	o f f e1 s i
offeso	o f f e1 s o
oggimai	o dZZ dZZ i m a1 i
oggi	OO dZZ dZZ i
ogni	o1 JJ JJ i
ogniuno	o JJ JJ i u1 n o
ognora	o JJ JJ o1 r a
ohimè	o i m EE
oh	OO
oimè	o i m EE
oltraggio	o l t r a1 dZZ dZZ o
oltre	o1 l t r e
omai	o m a1 i
ombra	o1 m b r a
ombre	o1 m b r e
omeri	OO m e r i
omero	OO m e r o
onde	o1 n d e
onestamente	o n e s t a m e1 n t e
onesta	o n EE s t a
onestà	o n e s t a1
oneste	o n EE s t e
onesti	o n EE s t i
onestissima	o n e s t i1 s s i m a
onesto	o n EE s t o
onnipotente	o n n i p o t EE n t e
onorare	o n o r a1 r e
onoratamente	o n o r a t a m e1 n t e
onorata	o n o r a1 t a
onorati	o n o r a1 t i
onorato	o n o r a1 t o
onore	o n o1 r e
onorevole	o n o r e1 v o l e
onorevolmente	o n o r e v o l m e1 n t e
onori	o n o1 r i
onta	o1 n t a
o	o1
operando	o p e r a1 n d o
opera	OO p e r a
operare	o p e r a1 r e
operasse	o p e r a1 s s e
operata	o p e r a1 t a
operato	o p e r a1 t o
operazione	o p e r a ts ts j o1 n e
operazioni	o p e r a ts ts j o1 n i
opere	OO p e r e
opinione	o p i n j o1 n e
opinioni	o p i n j o1 n i
opporre	o p p o1 r r e
opportuna	o p p o r t u1 n a
opportune	o p p o r t u1 n e
opportuno	o p p o r t u1 n o
opposte	o p p o1 s t e
oppressa	o p p r EE s s a
oprando	o p r a1 n d o
oprano	OO p r a n o
opra	OO p r a
oprare	o p r a1 r e
oprate	o p r a1 t e
oprato	o p r a1 t o
oprò	o p r OO
oracoli	o r a1 k o l i
oracolo	o r a1 k o l o
oramai	o r a m a1 i
ora	OO r a
orazione	o r a ts ts j o1 n e
orazioni	o r a ts ts j o1 n i
orco	OO r k o
ordinare	o r d i n a1 r e
ordinarono	o r d i n a1 r o n o
ordinasse	o r d i n a1 s s e
ordinatamente	o r d i n a t a m e1 n t e
ordinata	o r d i n a1 t a
ordinate	o r d i n a1 t e
ordinati	o r d i n a1 t i
ordinato	o r d i n a1 t o
ordine	o1 r d i n e
ordini	o1 r d i n i
ordinò	o r d i n OO
orecchie	o r e1 k k j e
orecchi	o r e1 k k i
oreste	o r EE s t e
oretta	o r e1 t t a
orfeo	o r f EE o
orgoglio	o r g o1 LL LL o
orientale	o r j e n t a1 l e
orientali	o r j e n t a1 l i
oriente	o r j EE n t e
origine	o r i1 dZZ i n e
ormai	o r m a1 i
ornamenti	o r n a m e1 n t i
ornamento	o r n a m e1 n t o
ornare	o r n a1 r e
ornata	o r n a1 t a
ornate	o r n a1 t e
ornati	o r n a1 t i
ornato	o r n a1 t o
or	o1 r
oro	OO r o
orrevole	o r r e1 v o l e
orso	o1 r s o
oscura	o s k u1 r a
oscure	o s k u1 r e
oscuri	o s k u1 r i
oscurità	o s k u r i t a1
oscuro	o s k u1 r o
ossa	OO s s a
osservare	o s s e r v a1 r e
osservato	o s s e r v a1 t o
ostante	o s t a1 n t e
oste	OO s t e
ostinatamente	o s t i n a t a m e1 n t e
ostinata	o s t i n a1 t a
ostinato	o s t i n a1 t o
ottava	o t t a1 v a
ottaviano	o t t a v j a1 n o
ottavo	o t t a1 v o
ottenere	o t t e n e1 r e
ottenne	o t t e1 n n e
ottimamente	o t t i m a m e1 n t e
ottima	OO t t i m a
ottimi	OO t t i m i
ottimo	OO t t i m o
otto	OO t t o
ove	o1 v e
over	o1 v e r
ovidio	o v i1 d j o
ovunque	o v u1 ng k w e
ovvero	o v v e1 r o
ozio	OO ts ts j o
pace	p a1 tSS e
padiglioni	p a d i LL LL o1 n i
padova	p a1 d o v a
padre	p a1 d r e
padri	p a1 d r i
padrona	p a d r o1 n a
padrone	p a d r o1 n e
padroni	p a d r o1 n i
paesani	p a e z a1 n i
paese	p a e1 z e
paesi	p a e1 z i
paganelli	p a g a n EE l l i
pagare	p a g a1 r e
pagato	p a g a1 t o
pagina	p a1 dZZ i n a
pagine	p a1 dZZ i n e
paglia	p a1 LL LL a
paiano	p a1 j a n o
paia	p a1 j a
paiono	p a1 j o n o
paio	p a1 j o
palazzi	p a l a1 ts ts i
palazzo	p a l a1 ts ts o
palco	p a1 l k o
palermo	p a l EE r m o
palesare	p a l e z a1 r e
palese	p a l e1 z e
palesi	p a l e1 z i
pallida	p a1 l l i d a
pallide	p a1 l l i d e
pallidezza	p a l l i d e1 ts ts a
pallido	p a1 l l i d o
palma	p a1 l m a
palme	p a1 l m e
palo	p a1 l o
palude	p a l u1 d e
paludi	p a l u1 d i
pane	p a1 n e
panfilo	p a1 nf f i l o
pani	p a1 n i
panni	p a1 n n i
panno	p a1 n n o
paolo	p a1 o l o
paone	p a o1 n e
papa	p a1 p a
paradiso	p a r a d i1 z o
parche	p a1 r k e
parecchie	p a r e1 k k j e
parecchi	p a r e1 k k i
parentado	p a r e n t a1 d o
parente	p a r EE n t e
parenti	p a r EE n t i
pare	p a1 r e
parere	p a r e1 r e
paresse	p a r e1 s s e
paressero	p a r e1 s s e r o
parete	p a r e1 t e
pareti	p a r e1 t i
parevano	p a r e1 v a n o
pareva	p a r e1 v a
parigi	p a r i1 dZZ i
parimente	p a r i m e1 n t e
pari	p a1 r i
paris	p a1 r i s
parlamenti	p a r l a m e1 n t i
parlamento	p a r l a m e1 n t o
parlando	p a r l a1 n d o
parlano	p a1 r l a n o
parlante	p a r l a1 n t e
parla	p a1 r l a
parlare	p a r l a1 r e
parlari	p a r l a1 r i
parlarono	p a r l a1 r o n o
parlar	p a r l a1 r
parlasse	p a r l a1 s s e
parlato	p a r l a1 t o
parlava	p a r l a1 v a
parlerò	p a r l e r OO
parliamo	p a r l j a1 m o
parli	p a1 r l i
parlo	p a1 r l o
parlò	p a r l OO
parnaso	p a r n a1 z o
parola	p a r OO l a
parole	p a r OO l e
parrà	p a r r a1
parrebbe	p a r r EE b b e
parso	p a1 r s o
parta	p a1 r t a
partendo	p a r t EE n d o
partenza	p a r t EE n ts a
parte	p a1 r t e
particella	p a r t i tSS EE l l a
particelle	p a r t i tSS EE l l e
particolare	p a r t i k o l a1 r e
particolari	p a r t i k o l a1 r i
particolarmente	p a r t i k o l a r m e1 n t e
partii	p a r t i1 i
partimmo	p a r t i1 m m o
parti	p a1 r t i
partì	p a r t i1
partirai	p a r t i r a1 i
partirà	p a r t i r a1
partire	p a r t i1 r e
partirono	p a r t i1 r o n o
partirò	p a r t i r OO
partisce	p a r t i1 SS SS e
partisse	p a r t i1 s s e
partissi	p a r t i1 s s i
partitamente	p a r t i t a m e1 n t e
partita	p a r t i1 t a
partite	p a r t i1 t e
partiti	p a r t i1 t i
partito	p a r t i1 t o
partiva	p a r t i1 v a
parto	p a1 r t o
partorendo	p a r t o r EE n d o
partorì	p a r t o r i1
partorire	p a r t o r i1 r e
partorisce	p a r t o r i1 SS SS e
partoriscono	p a r t o r i1 s k o n o
partorisse	p a r t o r i1 s s e
partoriti	p a r t o r i1 t i
partorito	p a r t o r i1 t o
paruta	p a r u1 t a
paruto	p a r u1 t o
parve	p a1 r v e
parvero	p a1 r v e r o
pascendo	p a SS SS EE n d o
pasce	p a1 SS SS e
pascere	p a1 SS SS e r e
pascono	p a1 s k o n o
pasquino	p a s k w i1 n o
passaggio	p a s s a1 dZZ dZZ o
passando	p a s s a1 n d o
passano	p a1 s s a n o
passa	p a1 s s a
passare	p a s s a1 r e
passarono	p a s s a1 r o n o
passasse	p a s s a1 s s e
passata	p a s s a1 t a
passate	p a s s a1 t e
passati	p a s s a1 t i
passato	p a s s a1 t o
passavano	p a s s a1 v a n o
passava	p a s s a1 v a
passerà	p a s s e r a1
passiamo	p a s s j a1 m o
passione	p a s s j o1 n e
passioni	p a s s j o1 n i
passi	p a1 s s i
passo	p a1 s s o
passò	p a s s OO
pastore	p a s t o1 r e
pastori	p a s t o1 r i
pastura	p a s t u1 r a
paterna	p a t EE r n a
paterno	p a t EE r n o
paternostri	p a t e r n OO s t r i
pater	p a1 t e r
patire	p a t i1 r e
patisce	p a t i1 SS SS e
patito	p a t i1 t o
patria	p a1 t r j a
patrimonio	p a t r i m OO n j o
patti	p a1 t t i
patto	p a1 t t o
paura	p a u1 r a
paure	p a u1 r e
paurosa	p a u r o1 s a
paurose	p a u r o1 s e
paurosi	p a u r o1 s i
pauroso	p a u r o1 s o
pausa	p a1 u z a
pavia	p a v i1 a
pazientemente	p a ts ts j e n t e m e1 n t e
paziente	p a ts ts j EE n t e
pazienza	p a ts ts j EE n ts a
pazzamente	p a ts ts a m e1 n t e
pazza	p a1 ts ts a
pazzia	p a ts ts i1 a
pazzie	p a ts ts i1 e
pazzi	p a1 ts ts i
pazzo	p a1 ts ts o
peccare	p e k k a1 r e
peccati	p e k k a1 t i
peccato	p e k k a1 t o
pecora	p EE k o r a
pecore	p EE k o r e
pedale	p e d a1 l e
peggio	p EE dZZ dZZ o
peggiore	p e dZZ dZZ o1 r e
pegno	p e1 JJ JJ o
pellegrinaggio	p e l l e g r i n a1 dZZ dZZ o
pellegrino	p e l l e g r i1 n o
pelle	p EE l l e
pelli	p EE l l i
pelo	p e1 l o
pel	p e1 l
peltro	p e1 l t r o
pena	p e1 n a
pendente	p e n d EE n t e
pende	p EE n d e
pene	p EE n e
penetrare	p e n e t r a1 r e
penitenza	p e n i t EE n ts a
penna	p e1 n n a
penne	p e1 n n e
penosa	p e n o1 s a
penoso	p e n o1 s o
pensai	p e n s a1 i
pensando	p e n s a1 n d o
pensano	p EE n s a n o
pensa	p EE n s a
pensare	p e n s a1 r e
pensata	p e n s a1 t a
pensate	p e n s a1 t e
pensato	p e n s a1 t o
pensatore	p e n s a t o1 r e
pensava	p e n s a1 v a
pensiamo	p e n s j a1 m o
pensieri	p e n s j EE r i
pensiero	p e n s j EE r o
pensi	p EE n s i
penso	p EE n s o
pensò	p e n s OO
pensoso	p e n s o1 s o
penultima	p e n u1 l t i m a
peranco	p e r a1 ng k o
perche	p EE r k e
perché	p e r k e1
percossa	p e r k OO s s a
percosse	p e r k OO s s e
percosso	p e r k OO s s o
percuotere	p e r k w OO t e r e
perdei	p e r d e1 i
perdendo	p e r d EE n d o
perde	p EE r d e
perdere	p EE r d e r e
perdita	p EE r d i t a
perdizione	p e r d i ts ts j o1 n e
perdona	p e r d o1 n a
perdonare	p e r d o n a1 r e
perdonato	p e r d o n a1 t o
perdoni	p e r d o1 n i
perdono	p e r d o1 n o
perdonò	p e r d o n OO
perduta	p e r d u1 t a
perdute	p e r d u1 t e
perduti	p e r d u1 t i
perduto	p e r d u1 t o
peregrina	p e r e g r i1 n a
peregrino	p e r e g r i1 n o
perfettamente	p e r f e t t a m e1 n t e
perfetta	p e r f EE t t a
perfetto	p e r f EE t t o
perfezione	p e r f e ts ts j o1 n e
perfino	p e r f i1 n o
pericoli	p e r i1 k o l i
pericolo	p e r i1 k o l o
pericolosi	p e r i k o l o1 s i
pericoloso	p e r i k o l o1 s o
periodo	p e r i1 o d o
perire	p e r i1 r e
perisca	p e r i1 s k a
perle	p EE r l e
pero	p e1 r o
però	p e r OO
per	p e1 r
perpetua	p e r p EE t u a
perpetuo	p e r p EE t u o
persa	p EE r s a
perseverando	p e r s e v e r a1 n d o
perseveranza	p e r s e v e r a1 n ts a
persi	p EE r s i
persona	p e r s o1 n a
persone	p e r s o1 n e
persuadere	p e r s u a d e1 r e
persuase	p e r s u a1 z e
persuasione	p e r s u a z j o1 n e
persuasioni	p e r s u a z j o1 n i
pertanto	p e r t a1 n t o
pertugio	p e r t u1 dZZ o
perturbazioni	p e r t u r b a ts ts j o1 n i
perugia	p e r u1 dZZ a
pervengono	p e r v EE ng g o n o
pervenire	p e r v e n i1 r e
pervenisse	p e r v e n i1 s s e
pervenne	p e r v e1 n n e
pervennero	p e r v e1 n n e r o
pervenni	p e r v e1 n n i
pervenuta	p e r v e n u1 t a
pervenuti	p e r v e n u1 t i
pervenuto	p e r v e n u1 t o
perviene	p e r v i EE n e
pesce	p e1 SS SS e
pesci	p e1 SS SS i
pesi	p e1 s i
peso	p e1 s o
pessimo	p EE s s i m o
peste	p EE s t e
pestilenza	p e s t i l EE n ts a
petti	p EE t t i
petto	p EE t t o
pezza	p EE ts ts a
pezzi	p EE ts ts i
pezzo	p EE ts ts o
piaccia	p j a1 tSS tSS a
piacciono	p j a1 tSS tSS o n o
piacendo	p j a tSS EE n d o
piace	p j a1 tSS e
piacerà	p j a tSS e r a1
piacere	p j a tSS e1 r e
piaceri	p j a tSS e1 r i
piacesse	p j a tSS e1 s s e
piaceva	p j a tSS e1 v a
piacevole	p j a tSS e1 v o l e
piacevolezza	p j a tSS e v o l e1 ts ts a
piacevoli	p j a tSS e1 v o l i
piacevolmente	p j a tSS e v o l m e1 n t e
piaciuta	p j a tSS u1 t a
piaciuto	p j a tSS u1 t o
piacque	p j a1 k k w e
piacquero	p j a1 k k w e r o
piaga	p j a1 g a
piaghe	p j a1 g e
pianamente	p j a n a m e1 n t e
pianeta	p j a n e1 t a
pianeti	p j a n e1 t i
piangendo	p j a n dZZ EE n d o
piange	p j a1 n dZZ e
piangere	p j a1 n dZZ e r e
piano	p j a1 n o
pianse	p j a1 n s e
pianta	p j a1 n t a
piante	p j a1 n t e
pianti	p j a1 n t i
pianto	p j a1 n t o
pianura	p j a n u1 r a
pia	p i1 a
piazza	p j a1 ts ts a
piazze	p j a1 ts ts e
picciola	p i1 tSS tSS o l a
picciole	p i1 tSS tSS o l e
piccioli	p i tSS tSS OO l i
picciolo	p i tSS tSS OO l o
piccola	p i1 k k o l a
piccole	p i1 k k o l e
piccoli	p i1 k k o l i
piccolo	p i1 k k o l o
piede	p j EE d e
piedi	p j EE d i
piegare	p j e g a1 r e
piegato	p j e g a1 t o
pienamente	p j e n a m e1 n t e
piena	p j EE n a
piene	p j EE n e
pienezza	p j e n e1 ts ts a
pieni	p j EE n i
pieno	p j EE n o
piè	p j EE
piero	p j EE r o
pietosamente	p j e t o s a m e1 n t e
pietosa	p j e t o1 s a
pietose	p j e t o1 s e
pietosi	p j e t o1 s i
pietoso	p j e t o1 s o
pietra	p j EE t r a
pietre	p j EE t r e
pietro	p j e1 t r o
pigliando	p i LL LL a1 n d o
pigliano	p i1 LL LL a n o
piglia	p i1 LL LL a
pigliare	p i LL LL a1 r e
pigliarono	p i LL LL a1 r o n o
pigliasse	p i LL LL a1 s s e
pigliata	p i LL LL a1 t a
pigliate	p i LL LL a1 t e
pigliato	p i LL LL a1 t o
piglio	p i1 LL LL o
pigliò	p i LL LL OO
pigli	p i1 LL LL i
pigri	p i1 g r i
pigro	p i1 g r o
pilade	p i1 l a d e
pilato	p i l a1 t o
pino	p i1 n o
pioggia	p j OO dZZ dZZ a
piombo	p j o1 m b o
pio	p i1 o
piro	p i1 r o
pisa	p i1 s a
pistoia	p i s t OO j a
piume	p j u1 m e
più	p i u1
piuttosto	p j u t t OO s t o
plebe	p l EE b e
plebi	p l EE b i
pleiadi	p l EE j a d i
plinio	p l i1 n j o
plutone	p l u t o1 n e
poca	p OO k a
poche	p OO k e
pochi	p OO k i
poco	p OO k o
podestà	p o d e s t a1
poema	p o EE m a
poemi	p o EE m i
poesia	p o e z i1 a
poeta	p o EE t a
poetica	p o EE t i k a
poetiche	p o EE t i k e
poetici	p o EE t i tSS i
poetico	p o EE t i k o
poeti	p o EE t i
poggio	p OO dZZ dZZ o
poiché	p o i k e1
poi	p OO i
politica	p o l i1 t i k a
politici	p o l i1 t i tSS i
politico	p o l i1 t i k o
polo	p OO l o
polso	p o1 l s o
polvere	p o1 l v e r e
polverosi	p o l v e r o1 s i
pomeriggio	p o m e r i1 dZZ dZZ o
pomi	p o1 m i
pomo	p o1 m o
pompeo	p o m p EE o
ponendo	p o n EE n d o
ponente	p o n EE n t e
pone	p o1 n e
ponesse	p o n e1 s s e
poneva	p o n e1 v a
ponga	p o1 ng g a
pongono	p o1 ng g o n o
pongo	p o1 ng g o
poni	p o1 n i
ponno	p OO n n o
pontefice	p o n t e1 f i tSS e
pontefici	p o n t e1 f i tSS i
ponte	p o1 n t e
po	p o1
popolare	p o p o l a1 r e
popoli	p OO p o l i
popolo	p OO p o l o
pò	p OO
poppa	p o1 p p a
porci	p OO r tSS i
porco	p OO r k o
porgendo	p o r dZZ EE n d o
porge	p OO r dZZ e
porgere	p OO r dZZ e r e
porgesse	p o r dZZ e1 s s e
porgete	p o r dZZ e1 t e
porgeva	p o r dZZ e1 v a
porgi	p OO r dZZ i
porgono	p OO r g o n o
poria	p o r i1 a
porre	p o1 r r e
porrò	p o r r OO
porse	p OO r s e
porsero	p OO r s e r o
porsi	p OO r s i
portando	p o r t a1 n d o
portano	p OO r t a n o
portante	p o r t a1 n t e
porta	p OO r t a
portare	p o r t a1 r e
portarono	p o r t a1 r o n o
portasse	p o r t a1 s s e
portassero	p o r t a1 s s e r o
portasti	p o r t a1 s t i
portata	p o r t a1 t a
portate	p o r t a1 t e
portati	p o r t a1 t i
portato	p o r t a1 t o
portavano	p o r t a1 v a n o
portava	p o r t a1 v a
porte	p OO r t e
portino	p OO r t i n o
porti	p OO r t i
porto	p OO r t o
portò	p o r t OO
posa	p OO s a
poscia	p OO SS SS a
pose	p OO s e
posero	p o1 s e r o
posizione	p o z i ts ts j o1 n e
possano	p OO s s a n o
possa	p OO s s a
possedere	p o s s e d e1 r e
possedesse	p o s s e d e1 s s e
possedette	p o s s e d EE t t e
possente	p o s s EE n t e
possenti	p o s s EE n t i
possessione	p o s s e s s j o1 n e
possessioni	p o s s e s s j o1 n i
possiamo	p o s s j a1 m o
possiate	p o s s i a1 t e
possibile	p o s s i1 b i l e
possibili	p o s s i1 b i l i
possibilità	p o s s i b i l i t a1
possiede	p o s s j EE d e
possi	p OO s s i
possono	p OO s s o n o
posso	p OO s s o
posta	p o1 s t a
poste	p o1 s t e
posteri	p OO s t e r i
posterità	p o s t e r i t a1
posti	p o1 s t i
posto	p o1 s t o
potei	p o t e1 i
potendo	p o t EE n d o
potente	p o t EE n t e
potenti	p o t EE n t i
potentissimo	p o t e n t i1 s s i m o
potenza	p o t EE n ts a
potenze	p o t EE n ts e
potenzia	p o t EE n ts j a
poté	p o t e1
potere	p o t e1 r e
poterono	p o t e1 r o n o
potesse	p o t e1 s s e
potessero	p o t e1 s s e r o
potessi	p o t e1 s s i
poteste	p o t e1 s t e
potete	p o t e1 t e
potevano	p o t e1 v a n o
poteva	p o t e1 v a
potevi	p o t e1 v i
potrai	p o t r a1 i
potranno	p o t r a1 n n o
potrà	p o t r a1
potrebbe	p o t r EE b b e
potrei	p o t r EE i
potremmo	p o t r e1 m m o
potremo	p o t r e1 m o
potreste	p o t r e1 s t e
potresti	p o t r e1 s t i
potrete	p o t r e1 t e
potrò	p o t r OO
potuta	p o t u1 t a
potuti	p o t u1 t i
potuto	p o t u1 t o
poveramente	p o v e r a m e1 n t e
povera	p OO v e r a
povere	p OO v e r e
poveretta	p o v e r e1 t t a
poveri	p OO v e r i
poverissimo	p o v e r i1 s s i m o
povero	p OO v e r o
povertà	p o v e r t a1
pozzo	p o1 ts ts o
p	p
pranzo	p r a1 n dz o
prati	p r a1 t i
prato	p r a1 t o
precedente	p r e tSS e d EE n t e
precedenti	p r e tSS e d EE n t i
precettore	p r e tSS e t t o1 r e
preda	p r EE d a
predecessori	p r e d e tSS e s s o1 r i
predetta	p r e d e1 t t a
predette	p r e d e1 t t e
predetti	p r e d e1 t t i
predetto	p r e d e1 t t o
predisse	p r e d i1 s s e
pregai	p r e g a1 i
pregando	p r e g a1 n d o
pregare	p r e g a1 r e
pregarono	p r e g a1 r o n o
pregato	p r e g a1 t o
pregava	p r e g a1 v a
preghiamo	p r e g j a1 m o
preghiera	p r e g j EE r a
preghiere	p r e g j EE r e
preghi	p r EE g i
pregio	p r EE dZZ o
pregna	p r e1 JJ JJ a
prego	p r EE g o
pregò	p r e g OO
preme	p r EE m e
premessa	p r e m e1 s s a
premesse	p r e m e1 s s e
preminenza	p r e m i n EE n ts a
premio	p r EE m j o
prencipe	p r EE n tSS i p e
prencipi	p r EE n tSS i p i
prenda	p r EE n d a
prendendo	p r e n d EE n d o
prende	p r EE n d e
prendere	p r EE n d e r e
prenderò	p r e n d e r OO
prendesse	p r e n d e1 s s e
prendete	p r e n d e1 t e
prendeva	p r e n d e1 v a
prendiamo	p r e n d j a1 m o
prendi	p r EE n d i
prendono	p r EE n d o n o
prendo	p r EE n d o
preparato	p r e p a r a1 t o
presa	p r e1 s a
presenta	p r e z EE n t a
presentare	p r e z e n t a1 r e
presentava	p r e z e n t a1 v a
presente	p r e z EE n t e
presentimenti	p r e s e n t i m e1 n t i
presentimento	p r e s e n t i m e1 n t o
presenti	p r e z EE n t i
presentò	p r e z e n t OO
presenza	p r e z EE n ts a
presenzia	p r e z EE n ts j a
prese	p r e1 s e
presero	p r e1 s e r o
presi	p r e1 s i
preso	p r e1 s o
presso	p r EE s s o
prestamente	p r e s t a m e1 n t e
presta	p r EE s t a
prestare	p r e s t a1 r e
prestasse	p r e s t a1 s s e
prestato	p r e s t a1 t o
presti	p r EE s t i
presto	p r EE s t o
prestò	p r e s t OO
presumere	p r e z u1 m e r e
presunzione	p r e z u n ts j o1 n e
prete	p r EE t e
preterito	p r e t EE r i t o
preti	p r EE t i
previsioni	p r e v i z j o1 n i
preziose	p r e ts ts j o1 s e
preziosi	p r e ts ts j o1 s i
prezioso	p r e ts ts j o1 s o
prezzo	p r EE ts ts o
prima	p r i1 m a
primavera	p r i m a v EE r a
prime	p r i1 m e
primieramente	p r i m j e r a m e1 n t e
primiera	p r i m j EE r a
primiere	p r i m j EE r e
primieri	p r i m j EE r i
primiero	p r i m j EE r o
primi	p r i1 m i
primo	p r i1 m o
principale	p r i n tSS i p a1 l e
principali	p r i n tSS i p a1 l i
principalmente	p r i n tSS i p a l m e1 n t e
principato	p r i n tSS i p a1 t o
principe	p r i1 n tSS i p e
principii	p r i n tSS i1 p j i
principio	p r i n tSS i1 p j o
principi	p r i n tSS i1 p i
prisco	p r i1 s k o
priva	p r i1 v a
privatamente	p r i v a t a m e1 n t e
privata	p r i v a1 t a
privati	p r i v a1 t i
privato	p r i v a1 t o
privilegio	p r i v i l EE dZZ o
privi	p r i1 v i
privo	p r i1 v o
problema	p r o b l EE m a
procacciando	p r o k a tSS tSS a1 n d o
procacciano	p r o k a1 tSS tSS a n o
procaccia	p r o k a1 tSS tSS a
procacciare	p r o k a tSS tSS a1 r e
proceda	p r o tSS EE d a
procedendo	p r o tSS e d EE n d o
procede	p r o tSS EE d e
procedere	p r o tSS EE d e r e
procedesse	p r o tSS e d e1 s s e
procedette	p r o tSS e d EE t t e
procedono	p r o tSS EE d o n o
processione	p r o tSS e s s j o1 n e
processo	p r o tSS EE s s o
proda	p r OO d a
prodotta	p r o d o1 t t a
prodotte	p r o d o1 t t e
prodotti	p r o d o1 t t i
prodotto	p r o d o1 t t o
produce	p r o d u1 tSS e
produrre	p r o d u1 r r e
produsse	p r o d u1 s s e
professore	p r o f e s s o1 r e
profeta	p r o f EE t a
profeti	p r o f EE t i
profitto	p r o f i1 t t o
profondamente	p r o f o n d a m e1 n t e
profonda	p r o f o1 n d a
profonde	p r o f o1 n d e
profondi	p r o f o1 n d i
profondissimo	p r o f o n d i1 s s i m o
profondità	p r o f o n d i t a1
profondo	p r o f o1 n d o
progenie	p r o dZZ e n i1 e
progetto	p r o dZZ EE t t o
progresso	p r o g r EE s s o
prole	p r OO l e
promessa	p r o m e1 s s a
promesse	p r o m e1 s s e
promesso	p r o m e1 s s o
promettendo	p r o m e t t EE n d o
promette	p r o m e1 t t e
prometto	p r o m e1 t t o
promise	p r o m i1 z e
promisi	p r o m i1 z i
promontorio	p r o m o n t OO r j o
pronta	p r o1 n t a
pronti	p r o1 n t i
pronto	p r o1 n t o
propia	p r OO p j a
propie	p r OO p j e
propii	p r OO p j i
propio	p r OO p j o
proponimento	p r o p o n i m e1 n t o
proporre	p r o p o1 r r e
propose	p r o p o1 s e
proposito	p r o p OO z i t o
proposta	p r o p o1 s t a
proposto	p r o p o1 s t o
propriamente	p r o p r j a m e1 n t e
propria	p r OO p r j a
proprie	p r OO p r j e
proprietà	p r o p r j e t a1
proprio	p r OO p r j o
propri	p r OO p r i
prosa	p r OO z a
prosatori	p r o z a t o1 r i
proseguì	p r o s e g w i1
prose	p r OO z e
prospere	p r OO s p e r e
prosperità	p r o s p e r i t a1
prospero	p r OO s p e r o
prossimo	p r OO s s i m o
proteo	p r OO t e o
protesta	p r o t EE s t a
prova	p r OO v a
provare	p r o v a1 r e
provata	p r o v a1 t a
provate	p r o v a1 t e
provato	p r o v a1 t o
provava	p r o v a1 v a
provenzale	p r o v e n ts a1 l e
provenzali	p r o v e n ts a1 l i
prove	p r OO v e
proverbio	p r o v EE r b j o
provincia	p r o v i1 n tSS a
provò	p r o v OO
provvidenza	p r o v v i d EE n ts a
prudente	p r u d EE n t e
prudenti	p r u d EE n t i
prudenza	p r u d EE n ts a
pruni	p r u1 n i
pruova	p r w OO v a
pubblicato	p u b b l i k a1 t o
pubblicazione	p u b b l i k a ts ts j o1 n e
pubblico	p u1 b b l i k o
publica	p u1 b l i k a
publico	p u1 b l i k o
puccio	p u1 tSS tSS o
puerili	p u e r i1 l i
puerizia	p u e r i1 ts ts j a
puglia	p u1 LL LL a
pugna	p u1 JJ JJ a
pulcella	p u l tSS EE l l a
punire	p u n i1 r e
punizione	p u n i ts ts j o1 n e
punta	p u1 n t a
punte	p u1 n t e
punti	p u1 n t i
punto	p u1 n t o
puoi	p w OO i
puo	p w o1
può	p w OO
puote	p w OO t e
pura	p u1 r a
purché	p u r k e1
pure	p u1 r e
purissimo	p u r i1 s s i m o
purità	p u r i t a1
puro	p u1 r o
pur	p u1 r
purpureo	p u r p u1 r e o
puzzo	p u1 ts ts o
q	k
quai	k w a1 i
quà	k w a1
qualche	k w a1 l k e
qualcosa	k w a l k OO s a
quale	k w a1 l e
quali	k w a1 l i
qualità	k w a l i t a1
qual	k w a l
qualmente	k w a l m e1 n t e
qualora	k w a l o1 r a
qualunque	k w a l u1 ng k w e
quando	k w a1 n d o
quanta	k w a1 n t a
quante	k w a1 n t e
quanti	k w a1 n t i
quantità	k w a n t i t a1
quanto	k w a1 n t o
quantunque	k w a n t u1 ng k w e
quaranta	k w a r a1 n t a
quarta	k w a1 r t a
quartodecimo	k w a r t o d EE tSS i m o
quarto	k w a1 r t o
quasi	k w a1 z i
quattordici	k w a t t o1 r d i tSS i
quattro	k w a1 t t r o
quegli	k w e1 LL LL i
quei	k w e1 i
que	k w e1
quel	k w e1 l
quella	k w e1 l l a
quelle	k w e1 l l e
quelli	k w e1 l l i
quello	k w e1 l l o
quercia	k w EE r tSS a
querela	k w e r EE l a
questa	k w e1 s t a
queste	k w e1 s t e
questi	k w e1 s t i
questione	k w e s t j o1 n e
questioni	k w e s t j o1 n i
questo	k w e1 s t o
quiete	k w j EE t e
quieto	k w j EE t o
quì	k w i1
quinci	k w i1 n tSS i
quindici	k w i1 n d i tSS i
quindi	k w i1 n d i
quinta	k w i1 n t a
quintilio	k w i n t i1 l j o
quintodecimo	k w i n t o d EE tSS i m o
quinto	k w i1 n t o
quivi	k w i1 v i
rabbia	r a1 b b j a
raccogliendo	r a k k o LL LL EE n d o
raccoglie	r a k k OO LL LL e
raccogliere	r a k k OO LL LL e r e
raccolse	r a k k OO l s e
raccolta	r a k k OO l t a
raccolte	r a k k OO l t e
raccolti	r a k k OO l t i
raccolto	r a k k OO l t o
raccomando	r a k k o m a1 n d o
raccomandò	r a k k o m a n d OO
racconta	r a k k o1 n t a
raccontare	r a k k o n t a1 r e
raccontata	r a k k o n t a1 t a
raccontate	r a k k o n t a1 t e
raccontato	r a k k o n t a1 t o
racconti	r a k k o1 n t i
raccontò	r a k k o n t OO
raddoppia	r a d d o1 p p j a
raddoppiata	r a d d o p p j a1 t a
rade	r a1 d e
radicale	r a d i k a1 l e
radice	r a d i1 tSS e
radici	r a d i1 tSS i
rado	r a1 d o
ragazzo	r a g a1 ts ts o
raggio	r a1 dZZ dZZ o
raggi	r a1 dZZ dZZ i
ragguardatore	r a g g w a r d a t o1 r e
ragionamenti	r a dZZ o n a m e1 n t i
ragionamento	r a dZZ o n a m e1 n t o
ragionando	r a dZZ o n a1 n d o
ragiona	r a dZZ o1 n a
ragionare	r a dZZ o n a1 r e
ragionate	r a dZZ o n a1 t e
ragionato	r a dZZ o n a1 t o
ragionavano	r a dZZ o n a1 v a n o
ragionava	r a dZZ o n a1 v a
ragione	r a dZZ o1 n e
ragionevole	r a dZZ o n e1 v o l e
ragionevolmente	r a dZZ o n e v o l m e1 n t e
ragioniamo	r a dZZ o n j a1 m o
ragioni	r a dZZ o1 n i
ragiono	r a dZZ o1 n o
ragionò	r a dZZ o n OO
rallegrare	r a l l e g r a1 r e
rallegrati	r a l l e g r a1 t i
rame	r a1 m e
rami	r a1 m i
ramo	r a1 m o
rapidamente	r a p i d a m e1 n t e
rapido	r a1 p i d o
rapina	r a p i1 n a
rapita	r a p i1 t a
rapito	r a p i1 t o
rare	r a1 r e
raro	r a1 r o
ravenna	r a v e1 n n a
razionale	r a ts ts j o n a1 l e
reale	r e a1 l e
reali	r e a1 l i
realizzato	r e a l i dz dz a1 t o
realtà	r e a l t a1
reame	r e a1 m e
reami	r e a1 m i
rea	r EE a
reazione	r e a ts ts j o1 n e
recai	r e k a1 i
reca	r EE k a
recare	r e k a1 r e
recarono	r e k a1 r o n o
recasse	r e k a1 s s e
recata	r e k a1 t a
recate	r e k a1 t e
recati	r e k a1 t i
recato	r e k a1 t o
rechi	r EE k i
recita	r EE tSS i t a
recò	r e k OO
redenzione	r e d e n ts j o1 n e
redine	r EE d i n e
ree	r EE e
regge	r EE dZZ dZZ e
reggere	r EE dZZ dZZ e r e
reggeva	r e dZZ dZZ e1 v a
reggimento	r e dZZ dZZ i m e1 n t o
reggono	r EE g g o n o
regina	r e dZZ i1 n a
regione	r e dZZ o1 n e
regioni	r e dZZ o1 n i
regnando	r e JJ JJ a1 n d o
regnare	r e JJ JJ a1 r e
regnasse	r e JJ JJ a1 s s e
regnato	r e JJ JJ a1 t o
regnava	r e JJ JJ a1 v a
regni	r e1 JJ JJ i
regno	r e1 JJ JJ o
regnò	r e JJ JJ OO
regola	r EE g o l a
regole	r EE g o l e
reina	r e i1 n a
rei	r EE i
religione	r e l i dZZ o1 n e
religioni	r e l i dZZ o1 n i
religiosa	r e l i dZZ o1 s a
religiosi	r e l i dZZ o1 s i
religioso	r e l i dZZ o1 s o
reliquie	r e l i1 k w j e
remi	r EE m i
remo	r EE m o
renda	r EE n d a
rendendo	r e n d EE n d o
rende	r EE n d e
rendé	r e n d e1
rendere	r EE n d e r e
rendono	r EE n d o n o
rendo	r EE n d o
renduta	r e n d u1 t a
rendute	r e n d u1 t e
renduto	r e n d u1 t o
reni	r EE n i
reo	r EE o
repubblicana	r e p u b b l i k a1 n a
repubblicano	r e p u b b l i k a1 n o
repubblica	r e p u1 b b l i k a
reputata	r e p u t a1 t a
reputato	r e p u t a1 t o
reputava	r e p u t a1 v a
reputo	r EE p u t o
re	r EE
rese	r e1 s e
resistente	r e s i s t EE n t e
resistenti	r e s i s t EE n t i
resistenza	r e s i s t EE n ts a
resistere	r e s i1 s t e r e
restando	r e s t a1 n d o
restano	r EE s t a n o
resta	r EE s t a
restare	r e s t a1 r e
restarono	r e s t a1 r o n o
restasse	r e s t a1 s s e
restato	r e s t a1 t o
restava	r e s t a1 v a
restituita	r e s t i t u i1 t a
resto	r EE s t o
restò	r e s t OO
reti	r e1 t i
reverenza	r e v e r EE n ts a
riavere	r i a v e1 r e
ricca	r i1 k k a
ricche	r i1 k k e
ricchezza	r i k k e1 ts ts a
ricchezze	r i k k e1 ts ts e
ricchi	r i1 k k i
ricchissima	r i k k i1 s s i m a
ricchissimi	r i k k i1 s s i m i
ricchissimo	r i k k i1 s s i m o
ricco	r i1 k k o
ricercando	r i tSS e r k a1 n d o
ricercare	r i tSS e r k a1 r e
ricerca	r i tSS e1 r k a
ricercata	r i tSS e r k a1 t a
ricercato	r i tSS e r k a1 t o
ricetto	r i tSS EE t t o
riceva	r i tSS e1 v a
ricevere	r i tSS e1 v e r e
riceve	r i tSS e1 v e
ricevette	r i tSS e v EE t t e
ricevetti	r i tSS e v EE t t i
ricevi	r i tSS e1 v i
ricevuta	r i tSS e v u1 t a
ricevute	r i tSS e v u1 t e
ricevuti	r i tSS e v u1 t i
ricevuto	r i tSS e v u1 t o
richiedere	r i k j EE d e r e
richiede	r i k j EE d e
richiedeva	r i k j e d e1 v a
richiese	r i k j EE s e
richiesta	r i k j EE s t a
richiesto	r i k j EE s t o
ricominciò	r i k o m i n tSS OO
riconfortata	r i k o nf f o r t a1 t a
riconobbe	r i k o n o1 b b e
riconoscenza	r i k o n o SS SS EE n ts a
riconoscere	r i k o n o1 SS SS e r e
riconosciuta	r i k o n o SS SS u1 t a
riconosciuto	r i k o n o SS SS u1 t o
ricordanza	r i k o r d a1 n ts a
ricordare	r i k o r d a1 r e
ricorda	r i k OO r d a
ricordata	r i k o r d a1 t a
ricordate	r i k o r d a1 t e
ricordato	r i k o r d a1 t o
ricordava	r i k o r d a1 v a
ricordi	r i k OO r d i
ricordo	r i k OO r d o
ricordò	r i k o r d OO
ridendo	r i d EE n d o
ridente	r i d EE n t e
ridere	r i1 d e r e
ride	r i1 d e
rideva	r i d e1 v a
ridire	r i d i1 r e
ridotti	r i d o1 t t i
ridotto	r i d o1 t t o
ridusse	r i d u1 s s e
rientrare	r i e n t r a1 r e
rientrò	r i e n t r OO
riforme	r i f o1 r m e
rifugio	r i f u1 dZZ o
rigido	r i1 dZZ i d o
riguardando	r i g w a r d a1 n d o
riguardanti	r i g w a r d a1 n t i
riguardare	r i g w a r d a1 r e
riguarda	r i g w a1 r d a
riguardate	r i g w a r d a1 t e
riguardato	r i g w a r d a1 t o
riguardavano	r i g w a r d a1 v a n o
riguardava	r i g w a r d a1 v a
riguardevole	r i g w a r d e1 v o l e
riguardevoli	r i g w a r d e1 v o l i
riguardi	r i g w a1 r d i
riguardo	r i g w a1 r d o
riguardò	r i g w a r d OO
rimanendo	r i m a n EE n d o
rimanente	r i m a n EE n t e
rimanenti	r i m a n EE n t i
rimanere	r i m a1 n e r e
rimane	r i m a1 n e
rimanesse	r i m a n e1 s s e
rimaneva	r i m a n e1 v a
rimanga	r i m a1 ng g a
rimangono	r i m a1 ng g o n o
rima	r i1 m a
rimarrà	r i m a r r a1
rimasa	r i m a1 s a
rimase	r i m a1 s e
rimasero	r i m a1 s e r o
rimasi	r i m a1 s i
rimaso	r i m a1 s o
rimasta	r i m a1 s t a
rimasto	r i m a1 s t o
rimedio	r i m EE d j o
rimedi	r i m EE d i
rimessa	r i m e1 s s a
rimesso	r i m e1 s s o
rimettere	r i m e1 t t e r e
rimirando	r i m i r a1 n d o
rimirare	r i m i r a1 r e
rimira	r i m i1 r a
rimirava	r i m i r a1 v a
rimise	r i m i1 z e
rimosse	r i m OO s s e
rimprovero	r i m p r OO v e r o
rimuovere	r i m w OO v e r e
rinaldo	r i n a1 l d o
rinchiusa	r i ng k j u1 s a
rinchiuse	r i ng k j u1 s e
rinchiusi	r i ng k j u1 s i
rinchiuso	r i ng k j u1 s o
ringraziando	r i ng g r a ts ts j a1 n d o
ringraziare	r i ng g r a ts ts j a1 r e
ringrazio	r i ng g r a1 ts ts j o
ringraziò	r i ng g r a ts ts j OO
ripa	r i1 p a
riparo	r i p a1 r o
ripe	r i1 p e
ripiena	r i p j EE n a
ripieno	r i p j EE n o
ripigliando	r i p i LL LL a1 n d o
ripigliare	r i p i LL LL a1 r e
riportò	r i p o r t OO
riposata	r i p o s a1 t a
riposato	r i p o s a1 t o
ripose	r i p o1 s e
riposi	r i p OO s i
riposo	r i p OO s o
riposti	r i p o1 s t i
riposto	r i p o1 s t o
riprendere	r i p r EE n d e r e
riprensione	r i p r e n s j o1 n e
riprensioni	r i p r e n s j o1 n i
riprensori	r i p r e n s o1 r i
ripresa	r i p r e1 s a
riprese	r i p r e1 s e
ripreso	r i p r e1 s o
risaltare	r i s a l t a1 r e
risapesse	r i s a p e1 s s e
risa	r i1 s a
riscaldato	r i s k a l d a1 t o
rise	r i1 s e
risguardo	r i z g w a1 r d o
risolve	r i s OO l v e
risonanti	r i s o n a1 n t i
risonare	r i s o n a1 r e
risorgimento	r i s o r dZZ i m e1 n t o
riso	r i1 s o
rispetto	r i s p EE t t o
risplendente	r i s p l e n d EE n t e
risponda	r i s p o1 n d a
rispondendo	r i s p o n d EE n d o
rispondere	r i s p o1 n d e r e
risponde	r i s p o1 n d e
rispondesse	r i s p o n d e1 s s e
rispondeva	r i s p o n d e1 v a
rispose	r i s p o1 s e
risposero	r i s p o1 s e r o
risposi	r i s p OO z i
risposta	r i s p o1 s t a
risposte	r i s p o1 s t e
risposto	r i s p o1 s t o
ristette	r i s t e1 t t e
ristorare	r i s t o r a1 r e
ristretti	r i s t r e1 t t i
risuona	r i s w OO n a
risuscitato	r i s u SS SS i t a1 t o
ritegno	r i t EE JJ JJ o
ritenere	r i t e n e1 r e
ritenne	r i t e1 n n e
ritenuto	r i t e n u1 t o
ritiene	r i t j EE n e
ritondo	r i t o1 n d o
ritornando	r i t o r n a1 n d o
ritornano	r i t o1 r n a n o
ritornare	r i t o r n a1 r e
ritorna	r i t o1 r n a
ritornarono	r i t o r n a1 r o n o
ritornasse	r i t o r n a1 s s e
ritornata	r i t o r n a1 t a
ritornato	r i t o r n a1 t o
ritornava	r i t o r n a1 v a
ritorni	r i t o1 r n i
ritorno	r i t o1 r n o
ritornò	r i t o r n OO
ritrarre	r i t r a1 r r e
ritratto	r i t r a1 t t o
ritrosa	r i t r o1 s a
ritrovando	r i t r o v a1 n d o
ritrovare	r i t r o v a1 r e
ritrova	r i t r OO v a
ritrovarono	r i t r o v a1 r o n o
ritrovasse	r i t r o v a1 s s e
ritrovata	r i t r o v a1 t a
ritrovati	r i t r o v a1 t i
ritrovato	r i t r o v a1 t o
ritrovò	r i t r o v OO
riuscire	r i u SS SS i1 r e
riuscì	r i u SS SS i1
riuscita	r i u SS SS i1 t a
riuscito	r i u SS SS i1 t o
riusciva	r i u SS SS i1 v a
riva	r i1 v a
rivedere	r i v e d e1 r e
riverenza	r i v e r EE n ts a
rive	r i1 v e
rivestire	r i v e s t i1 r e
rivestito	r i v e s t i1 t o
rivolgea	r i v o l dZZ EE a
rivolgendo	r i v o l dZZ EE n d o
rivolgere	r i v OO l dZZ e r e
rivolge	r i v OO l dZZ e
rivolse	r i v OO l s e
rivolta	r i v OO l t a
rivolti	r i v OO l t i
rivolto	r i v OO l t o
rivoluzione	r i v o l u ts ts j o1 n e
roberto	r o b EE r t o
robespierre	r o b e s p j EE r r e
robusto	r o b u1 s t o
rocca	r OO k k a
rodano	r o1 d a n o
rodi	r OO d i
rogo	r OO g o
romagna	r o m a1 JJ JJ a
romana	r o m a1 n a
romani	r o m a1 n i
romano	r o m a1 n o
romanzo	r o m a1 n dz o
roma	r o1 m a
romolo	r OO m o l o
rompere	r o1 m p e r e
rompe	r o1 m p e
ronzino	r o n dz i1 n o
rosa	r OO z a
rose	r o1 s e
rossa	r o1 s s a
rossi	r o1 s s i
rossore	r o s s o1 r e
rosso	r o1 s s o
rota	r OO t a
rotta	r o1 t t a
rotte	r o1 t t e
rotti	r o1 t t i
rotto	r o1 t t o
rovina	r o v i1 n a
rovinata	r o v i n a1 t a
rozza	r OO ts ts a
rozze	r OO ts ts e
rozzi	r o1 dz dz i
rozzo	r o1 dz dz o
r	r
rubato	r u b a1 t o
ruggieri	r u dZZ dZZ e1 r i
rugiada	r u dZZ a1 d a
ruina	r u i1 n a
ruine	r u i1 n e
rumore	r u m o1 r e
ruota	r w OO t a
ruote	r w OO t e
rupe	r u1 p e
ruppe	r u1 p p e
rustico	r u1 s t i k o
sabato	s a1 b a t o
sacerdote	s a tSS e r d OO t e
sacerdoti	s a tSS e r d OO t i
sacra	s a1 k r a
sacrato	s a k r a1 t o
sacre	s a1 k r e
sacrificando	s a k r i f i k a1 n d o
sacrificare	s a k r i f i k a1 r e
sacrificii	s a k r i f i1 tSS i i
sacrificio	s a k r i f i1 tSS o
sacrifici	s a k r i f i1 tSS i
sacrifizio	s a k r i f i1 ts ts j o
sacri	s a1 k r i
sacro	s a1 k r o
saettamento	s a e t t a m e1 n t o
saetta	s a e1 t t a
saette	s a e1 t t e
sagacità	s a g a tSS i t a1
saggio	s a1 dZZ dZZ o
saggi	s a1 dZZ dZZ i
sai	s a1 i
saladino	s a l a d i1 n o
salamone	s a l a m o1 n e
sala	s a1 l a
salate	s a l a1 t e
salendo	s a l EE n d o
salerno	s a l EE r n o
sale	s a1 l e
salire	s a l i1 r e
salì	s a l i1
saliti	s a l i1 t i
salito	s a l i1 t o
saliva	s a l i1 v a
salomone	s a l o m o1 n e
salutata	s a l u t a1 t a
salute	s a l u1 t e
saluto	s a l u1 t o
salutò	s a l u t OO
salva	s a1 l v a
salvatico	s a l v a1 t i k o
salvatore	s a l v a t o1 r e
salvezza	s a l v e1 ts ts a
salvia	s a1 l v j a
salvi	s a1 l v i
salvo	s a1 l v o
sanamente	s a n a m e1 n t e
sana	s a1 n a
sangue	s a1 ng g w e
sanguinosi	s a ng g w i n o1 s i
sanguinoso	s a ng g w i n o1 s o
sani	s a1 n i
sanità	s a n i t a1
sanno	s a1 n n o
sano	s a1 n o
san	s a1 n
santa	s a1 n t a
sante	s a1 n t e
santifica	s a n t i1 f i k a
santi	s a1 n t i
santissima	s a n t i1 s s i m a
santissimi	s a n t i1 s s i m i
santissimo	s a n t i1 s s i m o
santità	s a n t i t a1
santo	s a1 n t o
sanza	s a1 n ts a
sapendo	s a p EE n d o
sapere	s a p e1 r e
saperlo	s a p e1 r l o
sapessero	s a p e1 s s e r o
sapesse	s a p e1 s s e
sapessi	s a p e1 s s i
sapeste	s a p e1 s t e
sapete	s a p e1 t e
sapevano	s a p e1 v a n o
sapeva	s a p e1 v a
sapienza	s a p j EE n ts a
sapore	s a p o1 r e
sappiamo	s a p p j a1 m o
sappia	s a1 p p j a
sappiate	s a p p j a1 t e
sappiendo	s a p p j EE n d o
sappi	s a1 p p i
saprà	s a p r a1
saprei	s a p r EE i
saprò	s a p r OO
saputa	s a p u1 t a
saputo	s a p u1 t o
saracini	s a r a tSS i1 n i
sarai	s a r a1 i
saranno	s a r a1 n n o
sarà	s a r a1
sardigna	s a r d i1 JJ JJ a
sarebbero	s a r EE b b e r o
sarebbe	s a r EE b b e
sarei	s a r EE i
saremmo	s a r e1 m m o
saremo	s a r e1 m o
saresti	s a r e1 s t i
sarete	s a r e1 t e
saria	s a r i1 a
sarò	s a r OO
sa	s a1
sassi	s a1 s s i
sasso	s a1 s s o
saturnali	s a t u r n a1 l i
saturno	s a t u1 r n o
saviamente	s a v j a m e1 n t e
savia	s a1 v j a
savie	s a1 v j e
savio	s a1 v j o
savi	s a1 v i
sazia	s a1 ts ts j a
sazietà	s a ts ts j e t a1
scacchi	s k a1 k k i
scacciato	s k a tSS tSS a1 t o
scala	s k a1 l a
scalza	s k a1 l ts a
scambiò	s k a m b j OO
scampa	s k a1 m p a
scampo	s k a1 m p o
scendendo	SS e n d EE n d o
scendere	SS e1 n d e r e
scende	SS e1 n d e
scene	SS EE n e
scesa	SS e1 s a
scese	SS e1 s e
sceso	SS e1 s o
scettro	SS EE t t r o
scherzando	s k e r ts a1 n d o
scherzi	s k e1 r ts i
schiave	s k j a1 v e
schiera	s k j EE r a
schiere	s k j EE r e
schifare	s k i f a1 r e
sciagura	SS a g u1 r a
sciagure	SS a g u1 r e
scienza	SS EE n ts a
scienze	SS EE n ts e
scienziati	SS e n ts j a1 t i
sciocca	SS OO k k a
sciocche	SS OO k k e
sciocchezza	SS o k k e1 ts ts a
sciocchi	SS OO k k i
sciocco	SS OO k k o
sciogliere	SS OO LL LL e r e
scipione	SS i p j o1 n e
scolare	s k o l a1 r e
scolastica	s k o l a1 s t i k a
sconce	s k o1 n tSS e
sconciamente	s k o n tSS a m e1 n t e
sconcia	s k o1 n tSS a
sconsolata	s k o n s o l a1 t a
scoperse	s k o p EE r s e
scoperta	s k o p EE r t a
scoperto	s k o p EE r t o
scopo	s k OO p o
scoppio	s k OO p p j o
scoprire	s k o p r i1 r e
scorgere	s k OO r dZZ e r e
scorpione	s k o r p j o1 n e
scorta	s k OO r t a
scossa	s k OO s s a
scosse	s k OO s s e
scrissero	s k r i1 s s e r o
scrisse	s k r i1 s s e
scritta	s k r i1 t t a
scritte	s k r i1 t t e
scritti	s k r i1 t t i
scrittore	s k r i t t o1 r e
scrittori	s k r i t t o1 r i
scritto	s k r i1 t t o
scrittura	s k r i t t u1 r a
scritture	s k r i t t u1 r e
scriva	s k r i1 v a
scrivendo	s k r i v EE n d o
scriverà	s k r i v e r a1
scrivere	s k r i1 v e r e
scrive	s k r i1 v e
scrivi	s k r i1 v i
scrivono	s k r i1 v o n o
scudo	s k u1 d o
scuola	s k w OO l a
scuole	s k w OO l e
scure	s k u1 r e
scusare	s k u z a1 r e
scusa	s k u1 z a
sdegnata	z d e JJ JJ a1 t a
sdegnato	z d e JJ JJ a1 t o
sdegni	z d e1 JJ JJ i
sdegnoso	z d e JJ JJ o1 s o
sdegno	z d e1 JJ JJ o
sdrucciolosa	z d r u tSS tSS o l o1 s a
sebastiano	s e b a s t j a1 n o
sebbene	s e b b EE n e
secca	s e1 k k a
secco	s e1 k k o
secolari	s e k o l a1 r i
secoli	s EE k o l i
secolo	s EE k o l o
seconda	s e k o1 n d a
seconde	s e k o1 n d e
secondo	s e k o1 n d o
seco	s e1 k o
securo	s e k u1 r o
sedendo	s e d EE n d o
sedere	s e d e1 r e
sedeva	s e d e1 v a
sedia	s EE d j a
sedie	s EE d j e
seggiolone	s e dZZ dZZ o l o1 n e
seggio	s EE dZZ dZZ o
segnale	s e JJ JJ a1 l e
segnali	s e JJ JJ a1 l i
segnato	s e JJ JJ a1 t o
segni	s e1 JJ JJ i
segno	s e1 JJ JJ o
segretamente	s e g r e t a m e1 n t e
segreta	s e g r e1 t a
segreti	s e g r e1 t i
segreto	s e g r e1 t o
seguaci	s e g w a1 tSS i
segua	s e1 g w a
seguendo	s e g w EE n d o
seguente	s e g w EE n t e
seguenti	s e g w EE n t i
segue	s e1 g w e
seguirà	s e g w i r a1
seguire	s e g w i1 r e
seguirò	s e g w i r OO
seguì	s e g w i1
seguisse	s e g w i1 s s e
seguitando	s e g w i t a1 n d o
seguitare	s e g w i t a1 r e
seguita	s e g w i1 t a
seguitasse	s e g w i t a1 s s e
seguiti	s e g w i1 t i
seguito	s e g w i1 t o
seguitò	s e g w i t OO
seguiva	s e g w i1 v a
seguivi	s e g w i1 v i
seguono	s e1 g w o n o
sei	s EE i
selvaggio	s e l v a1 dZZ dZZ o
selvaggi	s e l v a1 dZZ dZZ i
selva	s e1 l v a
selve	s e1 l v e
sembiante	s e m b j a1 n t e
sembianti	s e m b j a1 n t i
sembianza	s e m b j a1 n ts a
sembianze	s e m b j a1 n ts e
seme	s e1 m e
seminò	s e m i n OO
semi	s e1 m i
semiviva	s e m i v i1 v a
sempiterna	s e m p i t EE r n a
semplicemente	s e m p l i tSS e m e1 n t e
semplice	s e1 m p l i tSS e
semplici	s e1 m p l i tSS i
semplicità	s e m p l i tSS i t a1
sempre	s EE m p r e
senno	s e1 n n o
sensibile	s e n s i1 b i l e
sensi	s EE n s i
senso	s EE n s o
senta	s EE n t a
sentendo	s e n t EE n d o
sentenza	s e n t EE n ts a
sentenze	s e n t EE n ts e
sentenzia	s e n t EE n ts j a
sente	s EE n t e
sentiamo	s e n t i a1 m o
sentiero	s e n t j EE r o
sentii	s e n t i1 i
sentimenti	s e n t i m e1 n t i
sentimento	s e n t i m e1 n t o
sentire	s e n t i1 r e
sentirono	s e n t i1 r o n o
senti	s EE n t i
sentì	s e n t i1
sentisse	s e n t i1 s s e
sentissi	s e n t i1 s s i
sentita	s e n t i1 t a
sentite	s e n t i1 t e
sentito	s e n t i1 t o
sentiva	s e n t i1 v a
sentono	s EE n t o n o
sento	s EE n t o
senza	s EE n ts a
separatamente	s e p a r a t a m e1 n t e
separate	s e p a r a1 t e
separato	s e p a r a1 t o
sepolcro	s e p o1 l k r o
sepolti	s e p o1 l t i
sepolto	s e p o1 l t o
sepoltura	s e p o l t u1 r a
seppero	s EE p p e r o
seppe	s EE p p e
seppi	s EE p p i
sera	s e1 r a
serbano	s EE r b a n o
serbare	s e r b a1 r e
serba	s EE r b a
serbato	s e r b a1 t o
serena	s e r e1 n a
serenissimo	s e r e n i1 s s i m o
serenità	s e r e n i t a1
sereno	s e r e1 n o
sere	s EE r e
sergenti	s e r dZZ EE n t i
seria	s EE r j a
serie	s EE r j e
serpente	s e r p EE n t e
serpenti	s e r p EE n t i
serpe	s EE r p e
serrata	s e r r a1 t a
serrato	s e r r a1 t o
serrò	s e r r OO
ser	s EE r
servano	s EE r v a n o
serva	s EE r v a
servente	s e r v EE n t e
serventi	s e r v EE n t i
serve	s EE r v e
servigio	s e r v i1 dZZ o
servigi	s e r v i1 dZZ i
servile	s e r v i1 l e
servire	s e r v i1 r e
servi	s EE r v i
servita	s e r v i1 t a
serviti	s e r v i1 t i
servito	s e r v i1 t o
servitù	s e r v i t u1
servivano	s e r v i1 v a n o
serviva	s e r v i1 v a
servono	s EE r v o n o
servo	s EE r v o
se	s e
sé	s e1
sesso	s EE s s o
sesta	s EE s t a
sesto	s EE s t o
sete	s EE t e
setta	s EE t t a
settembre	s e t t EE m b r e
settentrione	s e t t e n t r j o1 n e
sette	s EE t t e
settimana	s e t t i m a1 n a
settimane	s e t t i m a1 n e
settima	s EE t t i m a
settimo	s EE t t i m o
severa	s e v EE r a
severo	s e v EE r o
sforza	s f OO r ts a
sforzato	s f o r ts a1 t o
sfuggire	s f u dZZ dZZ i1 r e
sgomento	z g o m e1 n t o
sguardi	z g w a1 r d i
sguardo	z g w a1 r d o
siamo	s j a1 m o
siano	s i1 a n o
sia	s i1 a
siate	s j a1 t e
sibilla	s i b i1 l l a
siccome	s i k k o1 m e
sicilia	s i tSS i1 l i a
sic	s i1 k
sicuramente	s i k u r a m e1 n t e
sicura	s i k u1 r a
sicurezza	s i k u r e1 ts ts a
sicuri	s i k u1 r i
sicuro	s i k u1 r o
sicurtà	s i k u r t a1
siede	s j EE d e
siena	s j EE n a
sieno	s i1 e n o
siete	s j EE t e
significare	s i JJ JJ i f i k a1 r e
significa	s i JJ JJ i1 f i k a
significato	s i JJ JJ i f i k a1 t o
signora	s i JJ JJ o1 r a
signoreggia	s i JJ JJ o r e1 dZZ dZZ a
signoreggiato	s i JJ JJ o r e dZZ dZZ a1 t o
signoreggiava	s i JJ JJ o r e dZZ dZZ a1 v a
signoreggiò	s i JJ JJ o r e dZZ dZZ OO
signore	s i JJ JJ o1 r e
signoria	s i JJ JJ o r i1 a
signorina	s i JJ JJ o r i1 n a
signori	s i JJ JJ o1 r i
sii	s i1 i
silenzio	s i l EE n ts j o
sillaba	s i1 l l a b a
sillabe	s i1 l l a b e
silvio	s i1 l v j o
simile	s i1 m i l e
simili	s i1 m i l i
similitudine	s i m i l i t u1 d i n e
similmente	s i m i l m e1 n t e
simona	s i m o1 n a
simone	s i m o1 n e
simpatia	s i m p a t i1 a
simulacro	s i m u l a1 k r o
sincera	s i n tSS EE r a
sincerità	s i n tSS e r i t a1
sincero	s i n tSS EE r o
singolare	s i ng g o l a1 r e
singulare	s i ng g u l a1 r e
siniscalco	s i n i s k a1 l k o
sinistra	s i n i1 s t r a
sinistro	s i n i1 s t r o
sino	s i1 n o
sin	s i1 n
sintesi	s i1 n t e z i
siringa	s i r i1 ng g a
si	s i1
sì	s i1
sistema	s i s t EE m a
sito	s i1 t o
sit	s i1 t
situazione	s i t u a ts ts j o1 n e
slancio	z l a1 n tSS o
smarrita	z m a r r i1 t a
smarriti	z m a r r i1 t i
smarrito	z m a r r i1 t o
smemorato	z m e m o r a1 t o
smontati	z m o n t a1 t i
smontato	z m o n t a1 t o
soavemente	s o a v e m e1 n t e
soave	s o a1 v e
soavi	s o a1 v i
soavità	s o a v i t a1
soccorso	s o k k o1 r s o
sociale	s o tSS a1 l e
società	s o tSS e t a1
socrate	s OO k r a t e
soddisfazione	s o d d i s f a ts ts j o1 n e
sofferente	s o f f e r EE n t e
sofferenza	s o f f e r EE n ts a
sofferse	s o f f EE r s e
sofferto	s o f f EE r t o
soffiando	s o f f j a1 n d o
soffiare	s o f f j a1 r e
sofficiente	s o f f i tSS EE n t e
soffrire	s o f f r i1 r e
soggiunse	s o dZZ dZZ u1 n s e
soglia	s OO LL LL a
sogliono	s OO LL LL o n o
sogni	s o1 JJ JJ i
sogno	s o1 JJ JJ o
solamente	s o l a m e1 n t e
solari	s o l a1 r i
sola	s o1 l a
soldato	s o l d a1 t o
soldi	s OO l d i
solenne	s o l EE n n e
solenni	s o l EE n n i
solennità	s o l e n n i t a1
sole	s o1 l e
soleva	s o l e1 v a
solevi	s o l e1 v i
solingo	s o l i1 ng g o
solino	s o l i1 n o
soli	s o1 l i
solitaria	s o l i t a1 r j a
solitario	s o l i t a1 r j o
solita	s OO l i t a
solite	s OO l i t e
soliti	s OO l i t i
solito	s OO l i t o
solitudine	s o l i t u1 d i n e
solitudini	s o l i t u1 d i n i
sollazzando	s o l l a ts ts a1 n d o
sollazzi	s o l l a1 ts ts i
sollazzo	s o l l a1 ts ts o
sollecitamente	s o l l e tSS i t a m e1 n t e
sollecita	s o l l e tSS i1 t a
solleciti	s o l l e tSS i1 t i
sollecito	s o l l e tSS i1 t o
sollecitudine	s o l l e tSS i t u1 d i n e
sollecitudini	s o l l e tSS i t u1 d i n i
solo	s o1 l o
sol	s OO l
soltanto	s o l t a1 n t o
somigliante	s o m i LL LL a1 n t e
somiglianti	s o m i LL LL a1 n t i
somiglianza	s o m i LL LL a1 n ts a
sommamente	s o m m a m e1 n t e
somma	s o1 m m a
sommessa	s o m m e1 s s a
sommi	s o1 m m i
sommità	s o m m i t a1
sommo	s o1 m m o
sonando	s o n a1 n d o
sonanti	s o n a1 n t i
sonare	s o n a1 r e
sonarono	s o n a1 r o n o
sonetti	s o n e1 t t i
sonmi	s OO n m i
sonni	s o1 n n i
sonno	s o1 n n o
sonoro	s o n OO r o
sono	s OO n o
soperchio	s o p EE r k j o
sopportando	s o p p o r t a1 n d o
sopportare	s o p p o r t a1 r e
sopportò	s o p p o r t OO
sopra	s o1 p r a
sorda	s o1 r d a
sorella	s o r EE l l a
sorelle	s o r EE l l e
sorga	s OO r g a
sorpresa	s o r p r e1 s a
sorridendo	s o r r i d EE n d o
sorridere	s o r r i1 d e r e
sorriso	s o r r i1 s o
sorte	s OO r t e
sorti	s OO r t i
so	s o1
sospesi	s o s p e1 s i
sospeso	s o s p e1 s o
sospetti	s o s p EE t t i
sospetto	s o s p EE t t o
sospinto	s o s p i1 n t o
sospirando	s o s p i r a1 n d o
sospirare	s o s p i r a1 r e
sospiri	s o s p i1 r i
sospiro	s o s p i1 r o
sostanza	s o s t a1 n ts a
sostanze	s o s t a1 n ts e
sostegno	s o s t EE JJ JJ o
sostenendo	s o s t e n EE n d o
sostenere	s o s t e n e1 r e
sosteneva	s o s t e n e1 v a
sostenga	s o s t EE ng g a
sostennero	s o s t e1 n n e r o
sostenne	s o s t e1 n n e
sostenuta	s o s t e n u1 t a
sostenute	s o s t e n u1 t e
sostenuto	s o s t e n u1 t o
sostiene	s o s t j EE n e
sostieni	s o s t j EE n i
sostituire	s o s t i t u i1 r e
sotterra	s o t t EE r r a
sotterrato	s o t t e r r a1 t o
sottile	s o t t i1 l e
sottili	s o t t i1 l i
sottilissimo	s o t t i l i1 s s i m o
sottilmente	s o t t i l m e1 n t e
sottoposta	s o t t o p o1 s t a
sottoposti	s o t t o p o1 s t i
sotto	s o1 t t o
sovente	s o v EE n t e
soverchia	s o v EE r k j a
soverchio	s o v EE r k j o
sovra	s o1 v r a
sozzo	s o1 ts ts o
spada	s p a1 d a
spade	s p a1 d e
spagna	s p a1 JJ JJ a
spalla	s p a1 l l a
spalle	s p a1 l l e
sparse	s p a1 r s e
sparsi	s p a1 r s i
sparte	s p a1 r t e
sparve	s p a1 r v e
spaventato	s p a v e n t a1 t o
spaventevoli	s p a v e n t e1 v o l i
spavento	s p a v e1 n t o
spazio	s p a1 ts ts j o
specchio	s p EE k k j o
specialmente	s p e tSS a l m e1 n t e
specie	s p EE tSS e
specificata	s p e tSS i f i k a1 t a
spelonca	s p e l o1 ng k a
spelonche	s p e l o1 ng k e
speme	s p EE m e
spendendo	s p e n d EE n d o
spendere	s p EE n d e r e
spento	s p EE n t o
speranza	s p e r a1 n ts a
speranze	s p e r a1 n ts e
spera	s p EE r a
spesa	s p e1 s a
spese	s p e1 s e
speso	s p e1 s o
spesse	s p e1 s s e
spessissime	s p e s s i1 s s i m e
spesso	s p e1 s s o
speziale	s p e ts ts j a1 l e
spezie	s p EE ts ts j e
spiacevole	s p j a tSS e1 v o l e
spiare	s p i a1 r e
spiegazione	s p j e g a ts ts j o1 n e
spina	s p i1 n a
spine	s p i1 n e
spiraglio	s p i r a1 LL LL o
spirito	s p i1 r i t o
splendente	s p l e n d EE n t e
splendido	s p l EE n d i d o
splendore	s p l e n d o1 r e
splendori	s p l e n d o1 r i
spogliare	s p o LL LL a1 r e
spoglia	s p OO LL LL a
spogliati	s p o LL LL a1 t i
spogliato	s p o LL LL a1 t o
spontanea	s p o n t a1 n e a
sposa	s p OO z a
spose	s p OO z e
sposi	s p OO z i
sposo	s p OO z o
sposò	s p o z OO
sprezzando	s p r e ts ts a1 n d o
sprezzare	s p r e ts ts a1 r e
sprezzata	s p r e ts ts a1 t a
sprezzate	s p r e ts ts a1 t e
sprezzato	s p r e ts ts a1 t o
s	s
stabile	s t a1 b i l e
stabilità	s t a b i l i t a1
stagione	s t a dZZ o1 n e
stagioni	s t a dZZ o1 n i
stai	s t a1 i
stalla	s t a1 l l a
stamane	s t a m a1 n e
stanco	s t a1 ng k o
stando	s t a1 n d o
stanotte	s t a n OO t t e
stante	s t a1 n t e
stare	s t a1 r e
stassi	s t a1 s s i
sta	s t a1
stata	s t a1 t a
state	s t a1 t e
stati	s t a1 t i
stato	s t a1 t o
statua	s t a1 t u a
statue	s t a1 t u e
statura	s t a t u1 r a
statuto	s t a t u1 t o
stavano	s t a1 v a n o
stava	s t a1 v a
stella	s t e1 l l a
stelle	s t e1 l l e
stende	s t EE n d e
sterco	s t EE r k o
sterile	s t EE r i l e
stese	s t e1 s e
stessa	s t e1 s s a
stesse	s t e1 s s e
stessi	s t e1 s s i
stesso	s t e1 s s o
stia	s t i1 a
stile	s t i1 l e
stima	s t i1 m a
stimolato	s t i m o l a1 t o
stimoli	s t i1 m o l i
stimolo	s t i1 m o l o
stimo	s t i1 m o
stirpe	s t i1 r p e
stoltamente	s t o l t a m e1 n t e
stolta	s t o1 l t a
stolti	s t o1 l t i
stomaco	s t OO m a k o
stordito	s t o r d i1 t o
storia	s t OO r j a
storica	s t OO r i k a
storiche	s t OO r i k e
storico	s t OO r i k o
sto	s t o1
stracciato	s t r a tSS tSS a1 t o
strada	s t r a1 d a
strade	s t r a1 d e
stradoni	s t r a d o1 n i
stramba	s t r a1 m b a
strana	s t r a1 n a
strane	s t r a1 n e
straniera	s t r a n j EE r a
straniere	s t r a n j EE r e
stranieri	s t r a n j EE r i
straniero	s t r a n j EE r o
strani	s t r a1 n i
strano	s t r a1 n o
strazio	s t r a1 ts ts j o
strepiti	s t r EE p i t i
strepito	s t r EE p i t o
strettamente	s t r e t t a m e1 n t e
stretta	s t r e1 t t a
strette	s t r e1 t t e
stretti	s t r e1 t t i
stretto	s t r e1 t t o
strido	s t r i1 d o
strigne	s t r i1 JJ JJ e
strinse	s t r i1 n s e
strozza	s t r OO ts ts a
strumenti	s t r u m e1 n t i
studiare	s t u d j a1 r e
studiato	s t u d j a1 t o
studii	s t u1 d j i
studioso	s t u d j o1 s o
studio	s t u1 d j o
studi	s t u1 d i
stupefatto	s t u p e f a1 t t o
sua	s u1 a
sue	s w e
suggeriti	s u dZZ dZZ EE r i t i
surgea	s u r dZZ EE a
su	s u
tabarro	t a b a1 r r o
taccio	t a1 tSS tSS o
tacendo	t a tSS EE n d o
tacere	t a tSS e1 r e
taceva	t a tSS e1 v a
tacitamente	t a tSS i t a m e1 n t e
tacita	t a1 tSS i t a
taciti	t a1 tSS i t i
tacito	t a1 tSS i t o
taciuto	t a tSS u1 t o
tacque	t a1 k k w e
tagliata	t a LL LL a1 t a
tai	t a1 i
tale	t a1 l e
tali	t a1 l i
talora	t a l o1 r a
tal	t a1 l
taluno	t a l u1 n o
talvolta	t a l v OO l t a
tancredi	t a ng k r e1 d i
tandem	t a1 n d e m
tanta	t a1 n t a
tante	t a1 n t e
tanti	t a1 n t i
tanto	t a1 n t o
tarda	t a1 r d a
tardi	t a1 r d i
tardo	t a1 r d o
tartaro	t a1 r t a r o
tauro	t a1 u r o
tavola	t a1 v o l a
tavole	t a1 v o l e
tavolo	t a1 v o l o
tebano	t e b a1 n o
teco	t e1 k o
telamone	t e l a m o1 n e
tela	t e1 l a
tele	t e1 l e
tema	t e1 m a
temendo	t e m EE n d o
temere	t e m e1 r e
teme	t e1 m e
temeva	t e m e1 v a
temo	t e1 m o
temperanza	t e m p e r a1 n ts a
temperata	t e m p e r a1 t a
temperato	t e m p e r a1 t o
tempesta	t e m p EE s t a
tempeste	t e m p EE s t e
tempestoso	t e m p e s t o1 s o
tempie	t EE m p j e
tempio	t EE m p j o
tempi	t EE m p i
temporale	t e m p o r a1 l e
temporali	t e m p o r a1 l i
tempo	t EE m p o
temuto	t e m u1 t o
tenace	t e n a1 tSS e
tende	t EE n d e
tenebre	t EE n e b r e
tenendo	t e n EE n d o
teneramente	t e n e r a m e1 n t e
tenera	t EE n e r a
tenere	t e n e1 r e
tenerezza	t e n e r e1 ts ts a
tenerezze	t e n e r e1 ts ts e
tenero	t EE n e r o
tenesse	t e n e1 s s e
tenete	t e n e1 t e
tenevano	t e n e1 v a n o
teneva	t e n e1 v a
tenga	t EE ng g a
tengono	t EE ng g o n o
tengo	t EE ng g o
tennero	t e1 n n e r o
tenne	t e1 n n e
tenni	t e1 n n i
tentare	t e n t a1 r e
tentato	t e n t a1 t o
tentò	t e n t OO
tenuta	t e n u1 t a
tenute	t e n u1 t e
tenuti	t e n u1 t i
tenuto	t e n u1 t o
teodoro	t e o d OO r o
teologia	t e o l o dZZ i1 a
teologica	t e o l OO dZZ i k a
teologico	t e o l OO dZZ i k o
teorica	t e OO r i k a
terminare	t e r m i n a1 r e
termina	t EE r m i n a
termini	t EE r m i n i
terranova	t e r r a n OO v a
terra	t EE r r a
terrei	t e r r EE i
terrena	t e r r e1 n a
terrene	t e r r e1 n e
terreni	t e r r e1 n i
terreno	t e r r e1 n o
terre	t EE r r e
terribile	t e r r i1 b i l e
terribili	t e r r i1 b i l i
terrore	t e r r o1 r e
terrò	t e r r OO
terza	t EE r ts a
terze	t EE r ts e
terzodecimo	t e r ts o d EE tSS i m o
terzo	t EE r ts o
tese	t e1 s e
tesi	t EE z i
tesori	t e z OO r i
tesoro	t e z OO r o
tessa	t EE s s a
tessere	t EE s s e r e
testa	t EE s t a
testé	t e s t e1
testimoniano	t e s t i m OO n j a n o
testimonianza	t e s t i m o n j a1 n ts a
testimonia	t e s t i m OO n j a
testimonio	t e s t i m OO n j o
testimoni	t e s t i m OO n i
testo	t EE s t o
te	t e1
tetti	t e1 t t i
tetto	t e1 t t o
teucro	t EE u k r o
tiene	t j EE n e
tieni	t j EE n i
timida	t i1 m i d a
timidi	t i1 m i d i
timido	t i1 m i d o
timoni	t i m o1 n i
timore	t i m o1 r e
timori	t i m o1 r i
tinta	t i1 n t a
tirannia	t i r a n n i1 a
tiranno	t i r a1 n n o
tirare	t i r a1 r e
tirata	t i r a1 t a
tirate	t i r a1 t e
tira	t i1 r a
tirati	t i r a1 t i
tirato	t i r a1 t o
tiro	t i1 r o
tirò	t i r OO
titani	t i t a1 n i
titano	t i t a1 n o
ti	t i1
titoli	t i1 t o l i
titolo	t i1 t o l o
tito	t i1 t o
tizzone	t i ts ts o1 n e
toccando	t o k k a1 n d o
toccare	t o k k a1 r e
toccasse	t o k k a1 s s e
toccata	t o k k a1 t a
tocca	t o1 k k a
toccato	t o k k a1 t o
toccava	t o k k a1 v a
tocchi	t o1 k k i
tocco	t o1 k k o
toccò	t o k k OO
togliendo	t o LL LL EE n d o
togliesse	t o LL LL e1 s s e
toglie	t OO LL LL e
togli	t OO LL LL i
tolga	t OO l g a
tolse	t OO l s e
tolta	t OO l t a
tolte	t OO l t e
tolti	t OO l t i
tolto	t OO l t o
tomba	t o1 m b a
tommaso	t o m m a1 z o
tondo	t o1 n d o
tono	t OO n o
torello	t o r EE l l o
tormenta	t o r m e1 n t a
tormentato	t o r m e n t a1 t o
tormenti	t o r m e1 n t i
tormento	t o r m e1 n t o
tornando	t o r n a1 n d o
tornano	t o1 r n a n o
tornare	t o r n a1 r e
tornarono	t o r n a1 r o n o
tornasse	t o r n a1 s s e
tornata	t o r n a1 t a
tornati	t o r n a1 t i
torna	t o1 r n a
tornato	t o r n a1 t o
tornava	t o r n a1 v a
tornerò	t o r n e r OO
torni	t o1 r n i
torno	t o1 r n o
tornò	t o r n OO
torre	t OO r r e
torri	t o1 r r i
torti	t OO r t i
tor	t OO r
torto	t OO r t o
toscanamente	t o s k a n a m e1 n t e
toscana	t o s k a1 n a
toscane	t o s k a1 n e
toscani	t o s k a1 n i
tosto	t OO s t o
tradimento	t r a d i m e1 n t o
traditore	t r a d i t o1 r e
tradito	t r a d i1 t o
tradizione	t r a d i ts ts j o1 n e
tradotta	t r a d o1 t t a
traendo	t r a EE n d o
traesse	t r a e1 s s e
trae	t r a1 e
tragedia	t r a dZZ EE d i a
tragico	t r a1 dZZ i k o
tramontana	t r a m o n t a1 n a
tranquilla	t r a ng k w i1 l l a
tranquillità	t r a ng k w i l l i t a1
tranquillo	t r a ng k w i1 l l o
trapani	t r a1 p a n i
trapassare	t r a p a s s a1 r e
trapassata	t r a p a s s a1 t a
trapassato	t r a p a s s a1 t o
trapassi	t r a p a1 s s i
trapassò	t r a p a s s OO
trarre	t r a1 r r e
trascorrere	t r a s k o1 r r e r e
trasformato	t r a s f o r m a1 t o
trassero	t r a1 s s e r o
trasse	t r a1 s s e
tra	t r a
trattando	t r a t t a1 n d o
trattare	t r a t t a1 r e
trattato	t r a t t a1 t o
tratta	t r a1 t t a
trattava	t r a t t a1 v a
tratterà	t r a t t e r a1
tratte	t r a1 t t e
tratti	t r a1 t t i
tratto	t r a1 t t o
travagliati	t r a v a LL LL a1 t i
travagliato	t r a v a LL LL a1 t o
travagli	t r a v a1 LL LL i
trecento	t r e tSS EE n t o
tredici	t r e1 d i tSS i
tremando	t r e m a1 n d o
tremante	t r e m a1 n t e
tremanti	t r e m a1 n t i
tremare	t r e m a1 r e
tremava	t r e m a1 v a
trenta	t r e1 n t a
trentesimo	t r e n t EE z i m o
tre	t r EE
tribunali	t r i b u n a1 l i
trinità	t r i n i t a1
trionfo	t r i o1 nf f o
triplice	t r i1 p l i tSS e
trista	t r i1 s t a
triste	t r i1 s t e
tristezza	t r i s t e1 ts ts a
tristi	t r i1 s t i
tristizia	t r i s t i1 ts ts j a
tristo	t r i1 s t o
troiana	t r o j a1 n a
troiani	t r o j a1 n i
troiano	t r o j a1 n o
troia	t r OO j a
troncato	t r o ng k a1 t o
tronco	t r o1 ng k o
troppa	t r OO p p a
troppi	t r OO p p i
troppo	t r OO p p o
trovata	t r o v a1 t a
trovate	t r o v a1 t e
trovati	t r o v a1 t i
trovato	t r o v a1 t o
t	t
tua	t u1 a
tue	t u1 e
tullio	t u1 l l j o
tumulto	t u m u1 l t o
tunisi	t u1 n i z i
tuoni	t w OO n i
tuo	t u1 o
turbamento	t u r b a m e1 n t o
turbare	t u r b a1 r e
turbata	t u r b a1 t a
turbati	t u r b a1 t i
turbato	t u r b a1 t o
turba	t u1 r b a
turbò	t u r b OO
turno	t u1 r n o
tutta	t u1 t t a
tuttavia	t u t t a v i1 a
tutte	t u1 t t e
tutti	t u1 t t i
tutto	t u1 t t o
tu	t u
uccelli	u tSS tSS EE l l i
uccello	u tSS tSS EE l l o
uccidere	u tSS tSS i1 d e r e
uccisa	u tSS tSS i1 z a
uccise	u tSS tSS i1 z e
uccisi	u tSS tSS i1 z i
ucciso	u tSS tSS i1 z o
udendo	u d EE n d o
udii	u d i1 i
udine	u1 d i n e
udirete	u d i r e1 t e
udire	u d i1 r e
udita	u d i1 t a
udite	u d i1 t e
uditi	u d i1 t i
udito	u d i1 t o
udì	u d i1
udiva	u d i1 v a
ufficio	u f f i1 tSS o
uffici	u f f i1 tSS i
ugualmente	u g w a l m e1 n t e
ulisse	u l i1 s s e
ulteriori	u l t e r j o1 r i
ulteriormente	u l t e r j o r m e1 n t e
ultimamente	u l t i m a m e1 n t e
ultima	u1 l t i m a
ultime	u1 l t i m e
ultimi	u1 l t i m i
ultimo	u1 l t i m o
umana	u m a1 n a
umane	u m a1 n e
umanità	u m a n i t a1
umani	u m a1 n i
umano	u m a1 n o
umile	u1 m i l e
umili	u m i1 l i
umilmente	u m i l m e1 n t e
umiltà	u m i l t a1
una	u1 n a
undecimo	u n d EE tSS i m o
unico	u1 n i k o
unità	u n i t a1
uni	u1 n i
universale	u n i v e r s a1 l e
universalmente	u n i v e r s a l m e1 n t e
uno	u1 n o
un	u1 n
uomo	w OO m o
uopo	w OO p o
usando	u z a1 n d o
usano	u1 z a n o
usanza	u z a1 n ts a
usare	u z a1 r e
usarono	u z a1 r o n o
usasse	u z a1 s s e
usata	u z a1 t a
usate	u z a1 t e
usati	u z a1 t i
usato	u z a1 t o
usa	u1 z a
usavano	u z a1 v a n o
usava	u z a1 v a
uscendo	u SS SS EE n d o
uscio	u1 SS SS o
uscire	u SS SS i1 r e
uscirono	u SS SS i1 r o n o
uscisse	u SS SS i1 s s e
uscita	u SS SS i1 t a
usciti	u SS SS i1 t i
uscito	u SS SS i1 t o
uscì	u SS SS i1
usciva	u SS SS i1 v a
usiamo	u z j a1 m o
usi	u1 z i
uso	u1 z o
usò	u z OO
utile	u1 t i l e
utilità	u t i l i t a1
utili	u1 t i l i
ut	u1 t
vacca	v a1 k k a
vadano	v a1 d a n o
vada	v a1 d a
vagamente	v a g a m e1 n t e
vaga	v a1 g a
vaghe	v a1 g e
vaghezza	v a g e1 ts ts a
vaghi	v a1 g i
vaglia	v a1 LL LL a
vagliono	v a1 LL LL o n o
vago	v a1 g o
vai	v a1 i
valente	v a l EE n t e
valenti	v a l EE n t i
valere	v a l e1 r e
valerio	v a l EE r j o
valesse	v a l e1 s s e
vale	v a1 l e
valeva	v a l e1 v a
valle	v a1 l l e
valli	v a1 l l i
valore	v a l o1 r e
valorosamente	v a l o r o s a m e1 n t e
valorosa	v a l o r o1 s a
valorose	v a l o r o1 s e
valorosi	v a l o r o1 s i
valoroso	v a l o r o1 s o
valse	v a1 l s e
val	v a1 l
vana	v a1 n a
vane	v a1 n e
vanità	v a n i t a1
vani	v a1 n i
vanno	v a1 n n o
vano	v a1 n o
vantaggio	v a n t a1 dZZ dZZ o
vanto	v a1 n t o
van	v a1 n
vapori	v a p o1 r i
variazione	v a r j a ts ts j o1 n e
varietà	v a r j e t a1
varie	v a1 r j e
varii	v a1 r j i
vari	v a1 r i
vaso	v a1 z o
và	v a1
vecchiaia	v e k k j a1 j a
vecchia	v EE k k j a
vecchie	v EE k k j e
vecchiezza	v e k k j e1 ts ts a
vecchio	v EE k k j o
vecchi	v EE k k i
vece	v e1 tSS e
veda	v e1 d a
vedendo	v e d EE n d o
vedere	v e d e1 r e
vedessero	v e d e1 s s e r o
vedesse	v e d e1 s s e
vedessi	v e d e1 s s i
vedeste	v e d e1 s t e
vedesti	v e d e1 s t i
vedete	v e d e1 t e
vedevano	v e d e1 v a n o
vedeva	v e d e1 v a
vede	v e1 d e
vedi	v e1 d i
vedova	v e1 d o v a
vedove	v e1 d o v e
vedrai	v e d r a1 i
vedranno	v e d r a1 n n o
vedrà	v e d r a1
vedremo	v e d r e1 m o
vedrete	v e d r e1 t e
veduta	v e d u1 t a
vedute	v e d u1 t e
veduti	v e d u1 t i
veduto	v e d u1 t o
vegga	v e1 g g a
veggendo	v e dZZ dZZ EE n d o
veggiamo	v e dZZ dZZ a1 m o
veggia	v e1 dZZ dZZ a
veggio	v e1 dZZ dZZ o
veggono	v e1 g g o n o
veggo	v e1 g g o
vegnente	v e JJ JJ EE n t e
vela	v e1 l a
velenosa	v e l e n o1 s a
veleno	v e l e1 n o
vele	v e1 l e
veli	v e1 l i
vello	v EE l l o
velocemente	v e l o tSS e m e1 n t e
veloce	v e l o1 tSS e
velocissimo	v e l o tSS i1 s s i m o
velocità	v e l o tSS i t a1
velo	v e1 l o
vena	v e1 n a
vendere	v e1 n d e r e
vendetta	v e n d e1 t t a
vendicare	v e n d i k a1 r e
venduta	v e n d u1 t a
venduto	v e n d u1 t o
venendo	v e n EE n d o
venerabile	v e n e r a1 b i l e
venerdì	v e n e r d i1
venere	v EE n e r e
vene	v EE n e
vengano	v EE ng g a n o
venga	v EE ng g a
vengono	v EE ng g o n o
vengo	v EE ng g o
venia	v e n i1 a
venire	v e n i1 r e
venissero	v e n i1 s s e r o
venisse	v e n i1 s s e
venissi	v e n i1 s s i
venisti	v e n i1 s t i
venite	v e n i1 t e
venivano	v e n i1 v a n o
veniva	v e n i1 v a
vennero	v e1 n n e r o
venne	v EE n n e
venni	v EE n n i
ventesimo	v e n t EE z i m o
venti	v EE n t i
vento	v EE n t o
ventre	v EE n t r e
ventura	v e n t u1 r a
venture	v e n t u1 r e
venuta	v e n u1 t a
venute	v e n u1 t e
venuti	v e n u1 t i
venuto	v e n u1 t o
veramente	v e r a m e1 n t e
vera	v e1 r a
verbi	v EE r b i
verbo	v EE r b o
verde	v e1 r d e
verdi	v e1 r d i
vere	v e1 r e
verga	v EE r g a
verghe	v e1 r g e
vergine	v e1 r dZZ i n e
verginità	v e r dZZ i n i t a1
vergini	v e1 r dZZ i n i
vergognano	v e r g o1 JJ JJ a n o
vergognare	v e r g o JJ JJ a1 r e
vergogna	v e r g o1 JJ JJ a
vergognosamente	v e r g o JJ JJ o s a m e1 n t e
vergognosa	v e r g o JJ JJ o1 s a
vergognose	v e r g o JJ JJ o1 s e
vergognoso	v e r g o JJ JJ o1 s o
vergognò	v e r g o JJ JJ OO
verissima	v e r i1 s s i m a
verità	v e r i t a1
veri	v e1 r i
vermiglia	v e r m i1 LL LL a
vermiglie	v e r m i1 LL LL e
vermiglio	v e r m i1 LL LL o
vernaccia	v e r n a1 tSS tSS a
verno	v EE r n o
verona	v e r o1 n a
vero	v e1 r o
verrai	v e r r a1 i
verranno	v e r r a1 n n o
verrebbe	v e r r EE b b e
versi	v EE r s i
verso	v EE r s o
vertù	v e r t u1
veruna	v e r u1 n a
veruno	v e r u1 n o
ver	v EE r
vescovo	v e1 s k o v o
vespro	v EE s p r o
vesta	v EE s t a
veste	v EE s t e
vestigi	v e s t i1 dZZ i
vestimenti	v e s t i m e1 n t i
vestimento	v e s t i m e1 n t o
vestire	v e s t i1 r e
vestita	v e s t i1 t a
vestite	v e s t i1 t e
vestiti	v e s t i1 t i
vestito	v e s t i1 t o
vesti	v EE s t i
vetro	v e1 t r o
ve	v e1
vezzi	v e1 ts ts i
viaggio	v i a1 dZZ dZZ o
viaggi	v i a1 dZZ dZZ i
viandanti	v i a n d a1 n t i
via	v i1 a
vicario	v i k a1 r j o
vicenda	v i tSS EE n d a
vicina	v i tSS i1 n a
vicine	v i tSS i1 n e
vicini	v i tSS i1 n i
vicino	v i tSS i1 n o
videro	v i1 d e r o
vide	v i1 d e
vidi	v i1 d i
viene	v i EE n e
vieni	v i EE n i
vietato	v j e t a1 t o
vieta	v j EE t a
vige	v i1 dZZ e
vigilante	v i dZZ i l a1 n t e
vigilanza	v i dZZ i l a1 n ts a
vigile	v i1 dZZ i l e
vigilia	v i dZZ i1 l j a
vigilie	v i dZZ i1 l j e
vigne	v i1 JJ JJ e
vigore	v i g o1 r e
vigorosamente	v i g o r o s a m e1 n t e
vile	v i1 l e
vilissima	v i l i1 s s i m a
vili	v i1 l i
villaggi	v i l l a1 dZZ dZZ i
villana	v i l l a1 n a
villania	v i l l a n i1 a
villani	v i l l a1 n i
villano	v i l l a1 n o
villa	v i1 l l a
vilmente	v i l m e1 n t e
viltà	v i l t a1
vincendo	v i n tSS EE n d o
vincere	v i1 n tSS e r e
vince	v i1 n tSS e
vincitore	v i n tSS i t o1 r e
vincitori	v i n tSS i t o1 r i
vini	v i1 n i
vino	v i1 n o
vinse	v i1 n s e
vinta	v i1 n t a
vinte	v i1 n t e
vinti	v i1 n t i
vinto	v i1 n t o
violante	v i o l a1 n t e
violata	v i o l a1 t a
violenta	v i o l EE n t a
violento	v i o l EE n t o
violenza	v i o l EE n ts a
virgilio	v i r dZZ i1 l j o
virginità	v i r dZZ i n i t a1
virgulti	v i r g u1 l t i
virile	v i r i1 l e
virilmente	v i r i l m e1 n t e
virtuosamente	v i r t u o s a m e1 n t e
virtuosa	v i r t u o1 s a
virtuose	v i r t u o1 s e
virtuosi	v i r t u o1 s i
virtuoso	v i r t u o1 s o
virtù	v i r t u1
viscere	v i1 SS SS e r e
visibile	v i z i1 b i l e
visione	v i z j o1 n e
visioni	v i z j o1 n i
visitare	v i z i t a1 r e
visitato	v i z i t a1 t o
visita	v i1 z i t a
visi	v i1 z i
viso	v i1 z o
visse	v i1 s s e
vista	v i1 s t a
visto	v i1 s t o
vita	v i1 t a
viti	v i1 t i
vittoria	v i t t OO r j a
vittorie	v i t t OO r j e
vittoriosi	v i t t o r j o1 s i
vittorioso	v i t t o r j o1 s o
vituperevole	v i t u p e r e1 v o l e
vituperosamente	v i t u p e r o s a m e1 n t e
vivanda	v i v a1 n d a
vivande	v i v a1 n d e
viva	v i1 v a
vivendo	v i v EE n d o
vivente	v i v EE n t e
viventi	v i v EE n t i
viverà	v i v e r a1
vivere	v i1 v e r e
viveva	v i v e1 v a
vive	v i1 v e
vi	v i1
viviamo	v i v j a1 m o
vivi	v i1 v i
vivono	v i1 v o n o
vivo	v i1 v o
vivuto	v i v u1 t o
vizio	v i1 ts ts j o
vizi	v i1 ts ts i
vocaboli	v o k a1 b o l i
vocabolo	v o k a1 b o l o
vocale	v o k a1 l e
vocali	v o k a1 l i
voce	v o1 tSS e
voci	v o1 tSS i
vogliamo	v o LL LL a1 m o
vogliano	v OO LL LL a n o
vogliate	v o LL LL a1 t e
voglia	v OO LL LL a
voglie	v OO LL LL e
vogliono	v OO LL LL o n o
voglio	v OO LL LL o
vogli	v OO LL LL i
voi	v o1 i
volando	v o l a1 n d o
volanti	v o l a1 n t i
volare	v o l a1 r e
vola	v o1 l a
volendo	v o l EE n d o
volentieri	v o l e n t j EE r i
volere	v o l e1 r e
voleri	v o l e1 r i
volessero	v o l e1 s s e r o
volesse	v o l e1 s s e
volessimo	v o l e1 s s i m o
volessi	v o l e1 s s i
voleste	v o l e1 s t e
volete	v o l e1 t e
volevano	v o l e1 v a n o
voleva	v o l e1 v a
volevi	v o l e1 v i
volgare	v o l g a1 r e
volgari	v o l g a1 r i
volgarmente	v o l g a r m e1 n t e
volgendo	v o l dZZ EE n d o
volgere	v OO l dZZ e r e
volge	v OO l dZZ e
volgo	v OO l g o
vollero	v OO l l e r o
volle	v OO l l e
volli	v OO l l i
volontariamente	v o l o n t a r j a m e1 n t e
volontà	v o l o n t a1
volonteroso	v o l o n t e r o1 s o
volontieri	v o l o n t j EE r i
volo	v o1 l o
volò	v o l OO
volsero	v OO l s e r o
volse	v OO l s e
voltata	v o l t a1 t a
voltato	v o l t a1 t o
volta	v OO l t a
volte	v OO l t e
volti	v OO l t i
voltò	v o l t OO
volto	v OO l t o
volume	v o l u1 m e
volumi	v o l u1 m i
voluta	v o l u1 t a
voluti	v o l u1 t i
voluto	v o l u1 t o
voluttà	v o l u t t a1
vorrai	v o r r a1 i
vorrà	v o r r a1
vorrebbe	v o r r EE b b e
vorrei	v o r r EE i
vorremo	v o r r e1 m o
vorrete	v o r r e1 t e
vorrò	v o r r OO
vostra	v o s t r a
vostri	v o s t r i
voti	v OO t i
voto	v OO t o
vo	v o1
vulcano	v u l k a1 n o
vuogli	v w OO LL LL i
vuoi	v w OO i
vuole	v w OO l e
vuoto	v w OO t o
v	v
www	v u v u v u1
x	k s
zefiro	dz EE f i r o
zeppa	ts e1 p p a
zia	ts i1 a
zio	ts i1 o
zodiaco	dz o d i1 a k o
